,Rk,Player,Pos,Squad,Age,Born,90s,Tkl,TklW,Def 3rd,Mid 3rd,Att 3rd,Tkl.1,Att,Tkl%,Lost,Blocks,Sh,Pass,Int,Tkl+Int,Clr,Err,Matches
0,1,Che Adams,FW,sct Scotland,27-362,1996,2.3,2,1,1,1,0,1,1,100.0,0,2,0,2,1,3,0,0,Matches
1,2,Michel Aebischer,DF,ch Switzerland,27-185,1997,5.3,4,3,2,2,0,1,11,9.1,10,3,1,2,2,6,7,0,Matches
2,3,Arlind Ajeti,DF,al Albania,30-288,1993,3.0,1,0,0,1,0,1,3,33.3,2,5,4,1,6,7,13,0,Matches
3,4,Manuel Akanji,DF,ch Switzerland,28-356,1995,5.3,2,2,2,0,0,1,2,50.0,1,6,6,0,4,6,22,0,Matches
4,5,Samet Akaydın,DF,tr Türkiye,30-118,1994,3.7,8,4,8,0,0,6,8,75.0,2,5,5,0,7,15,16,0,Matches
5,6,Nathan Aké,DF,nl Netherlands,29-142,1995,4.2,6,5,6,0,0,4,6,66.7,2,3,2,1,6,12,12,0,Matches
6,7,Yunus Akgün,FW,tr Türkiye,24-002,2000,0.8,2,1,1,1,0,2,2,100.0,0,1,0,1,0,2,0,0,Matches
7,8,Kerem Aktürkoğlu,"FW,MF",tr Türkiye,25-262,1998,1.2,1,1,1,0,0,1,2,50.0,1,1,0,1,1,2,3,0,Matches
8,9,Trent Alexander-Arnold,"MF,DF",eng England,25-276,1998,1.5,1,0,1,0,0,0,1,0.0,1,4,2,2,2,3,3,1,Matches
9,10,Denis Alibec,FW,ro Romania,33-186,1991,0.3,0,0,0,0,0,0,0,,0,0,0,0,0,0,0,0,Matches
10,11,Barış Alper Yılmaz,FW,tr Türkiye,24-047,2000,5.0,5,0,0,3,2,1,3,33.3,2,1,0,1,0,5,1,0,Matches
11,12,Sandro Altunashvili,MF,ge Georgia,27-051,1997,0.6,0,0,0,0,0,0,0,,0,0,0,0,0,0,3,1,Matches
12,13,Zeki Amdouni,"MF,FW",ch Switzerland,23-218,2000,0.6,0,0,0,0,0,0,2,0.0,2,0,0,0,0,0,1,0,Matches
13,14,Joachim Andersen,DF,dk Denmark,28-039,1996,4.0,5,1,2,3,0,3,3,100.0,0,4,1,3,2,7,11,0,Matches
14,15,Robert Andrich,MF,de Germany,29-291,1994,3.5,12,8,8,4,0,5,7,71.4,2,3,1,2,2,14,12,0,Matches
15,16,Waldemar Anton,DF,de Germany,27-355,1996,0.4,0,0,0,0,0,0,0,,0,0,0,0,0,0,2,0,Matches
16,17,Stuart Armstrong,MF,sct Scotland,32-101,1992,0.2,1,0,1,0,0,0,0,,0,0,0,0,0,1,0,0,Matches
17,18,Marko Arnautović,FW,at Austria,35-081,1989,3.1,2,1,0,1,1,1,1,100.0,0,1,0,1,0,2,2,0,Matches
18,19,Jasir Asani,FW,al Albania,29-051,1995,2.3,3,1,3,0,0,1,7,14.3,6,1,0,1,4,7,4,0,Matches
19,20,Kristjan Asllani,MF,al Albania,22-122,2002,3.0,1,1,1,0,0,0,2,0.0,2,0,0,0,3,4,6,0,Matches
20,21,Kaan Ayhan,"MF,DF",tr Türkiye,29-242,1994,4.0,6,3,3,2,1,4,10,40.0,6,5,0,5,2,8,17,0,Matches
21,22,Alex Baena,"MF,FW",es Spain,22-355,2001,0.3,1,1,1,0,0,1,3,33.3,2,0,0,0,0,1,0,0,Matches
22,23,Alexander Bah,"DF,MF",dk Denmark,26-213,1997,3.1,4,4,2,1,1,4,8,50.0,4,1,0,1,5,9,5,0,Matches
23,24,Nedim Bajrami,"FW,MF",al Albania,25-132,1999,2.7,3,1,2,1,0,0,2,0.0,2,1,0,1,0,3,1,0,Matches
24,25,Johan Bakayoko,"FW,DF",be Belgium,21-080,2003,0.5,2,1,1,1,0,0,3,0.0,3,0,0,0,0,2,0,0,Matches
26,26,Jure Balkovec,DF,si Slovenia,29-304,1994,1.3,6,3,2,3,1,2,5,40.0,3,2,0,2,2,8,8,0,Matches
27,27,Iván Balliu,DF,al Albania,32-190,1992,1.0,0,0,0,0,0,0,0,,0,1,1,0,2,2,2,0,Matches
28,28,Nicușor Bancu,DF,ro Romania,31-295,1992,3.0,2,2,2,0,0,1,1,100.0,0,6,2,4,0,2,11,0,Matches
29,29,Antonín Barák,MF,cz Czechia,29-219,1994,0.5,1,1,0,0,1,0,1,0.0,1,0,0,0,0,1,0,0,Matches
30,30,Bradley Barcola,FW,fr France,21-311,2002,0.8,4,4,1,1,2,1,4,25.0,3,4,0,4,0,4,0,0,Matches
31,31,Abdülkerim Bardakcı,DF,tr Türkiye,29-306,1994,4.0,4,2,4,0,0,3,6,50.0,3,5,3,2,2,6,20,0,Matches
32,32,Nicolò Barella,MF,it Italy,27-153,1997,3.7,10,5,3,7,0,5,8,62.5,3,3,0,3,3,13,2,1,Matches
33,33,Alessandro Bastoni,DF,it Italy,25-087,1999,4.0,5,2,2,3,0,2,3,66.7,1,4,2,2,1,6,17,0,Matches
34,34,Martin Baturina,FW,hr Croatia,21-144,2003,0.1,1,1,0,1,0,0,0,,0,0,0,0,0,1,0,0,Matches
35,35,Christoph Baumgartner,"MF,FW",at Austria,24-343,1999,3.2,4,1,2,1,1,1,2,50.0,1,1,0,1,1,5,3,0,Matches
36,36,Altay Bayındır,GK,tr Türkiye,26-086,1998,1.0,0,0,0,0,0,0,0,,0,0,0,0,0,0,0,0,Matches
37,37,Jan Bednarek,DF,pl Poland,28-088,1996,3.0,2,1,2,0,0,2,6,33.3,4,8,7,1,3,5,13,0,Matches
38,38,Maximilian Beier,FW,de Germany,21-266,2002,0.3,0,0,0,0,0,0,0,,0,0,0,0,0,0,0,0,Matches
39,39,Jude Bellingham,MF,eng England,21-010,2003,5.4,9,6,1,4,4,1,5,20.0,4,5,1,4,2,11,4,1,Matches
40,40,László Bénes,MF,sk Slovakia,26-304,1997,0.8,1,1,0,0,1,1,1,100.0,0,0,0,0,0,1,1,0,Matches
41,41,Bartosz Bereszyński,DF,pl Poland,31-363,1992,0.1,0,0,0,0,0,0,0,,0,0,0,0,0,0,0,0,Matches
42,42,Steven Bergwijn,FW,nl Netherlands,26-275,1997,1.0,0,0,0,0,0,0,1,0.0,1,1,0,1,0,0,1,0,Matches
43,43,Medon Berisha,MF,al Albania,20-262,2003,0.2,0,0,0,0,0,0,0,,0,0,0,0,1,1,0,0,Matches
44,44,Victor Bernth Kristiansen,"DF,MF",dk Denmark,21-206,2002,1.7,4,3,3,1,0,1,2,50.0,1,2,0,2,0,4,4,1,Matches
45,45,Matúš Bero,"MF,DF",sk Slovakia,28-307,1995,0.5,1,1,0,1,0,0,0,,0,0,0,0,1,2,0,0,Matches
46,46,Jaka Bijol,DF,si Slovenia,25-155,1999,4.3,11,6,10,1,0,5,6,83.3,1,10,7,3,6,17,38,0,Matches
47,47,Veljko Birmančević,DF,rs Serbia,26-126,1998,0.3,0,0,0,0,0,0,0,,0,0,0,0,2,2,0,0,Matches
48,48,Daley Blind,FW,nl Netherlands,34-122,1990,0.0,0,0,0,0,0,0,0,,0,0,0,0,0,0,0,0,Matches
49,49,Bendegúz Bolla,DF,hu Hungary,24-230,1999,2.3,4,3,3,0,1,2,4,50.0,2,3,1,2,1,5,9,0,Matches
50,50,Endre Botka,DF,hu Hungary,29-319,1994,1.0,3,1,2,1,0,1,1,100.0,0,0,0,0,1,4,3,0,Matches
52,51,Jarrod Bowen,FW,eng England,27-202,1996,0.4,1,1,0,1,0,0,1,0.0,1,1,0,1,1,2,1,0,Matches
53,52,Róbert Boženík,FW,sk Slovakia,24-234,1999,2.3,3,3,0,3,0,0,1,0.0,1,1,0,1,0,3,3,0,Matches
54,53,Volodymyr Brazhko,MF,ua Ukraine,22-168,2002,2.0,8,5,5,3,0,1,1,100.0,0,2,1,1,5,13,4,0,Matches
55,54,David Brekalo,MF,si Slovenia,25-219,1998,0.0,0,0,0,0,0,0,0,,0,0,0,0,0,0,2,0,Matches
56,55,Armando Broja,FW,al Albania,22-303,2001,1.2,1,1,0,0,1,0,0,,0,0,0,0,0,1,1,0,Matches
57,56,Marcelo Brozović,MF,hr Croatia,31-236,1992,2.5,1,0,1,0,0,0,2,0.0,2,3,1,2,4,5,4,0,Matches
58,57,Jacob Bruun Larsen,FW,dk Denmark,25-294,1998,0.1,0,0,0,0,0,0,0,,0,0,0,0,0,0,0,0,Matches
59,58,Ante Budimir,FW,hr Croatia,32-353,1991,1.4,2,2,0,1,1,1,1,100.0,0,3,1,2,0,2,2,0,Matches
60,59,Adam Buksa,FW,pl Poland,27-363,1996,1.7,0,0,0,0,0,0,0,,0,4,0,4,0,0,3,0,Matches
61,60,Andrei Burcă,DF,ro Romania,31-085,1993,4.0,4,2,3,1,0,3,4,75.0,1,7,4,3,1,5,23,0,Matches
62,61,Riccardo Calafiori,DF,it Italy,22-051,2002,3.0,3,1,3,0,0,2,6,33.3,4,2,1,1,6,9,9,0,Matches
63,62,Hakan Çalhanoğlu,MF,tr Türkiye,30-152,1994,3.9,5,4,3,2,0,3,6,50.0,3,3,1,2,1,6,6,0,Matches
64,63,Eduardo Camavinga,MF,fr France,21-242,2002,1.6,4,2,3,0,1,1,3,33.3,2,7,1,6,1,5,5,0,Matches
65,64,Andrea Cambiaso,"FW,DF",it Italy,24-140,2000,0.8,4,4,4,0,0,3,4,75.0,1,1,1,0,0,4,0,0,Matches
66,65,Emre Can,MF,de Germany,30-179,1994,1.1,4,3,2,2,0,2,2,100.0,0,2,2,0,1,5,2,0,Matches
67,66,João Cancelo,"DF,MF",pt Portugal,30-043,1994,3.8,6,4,2,2,2,4,8,50.0,4,2,0,2,4,10,8,1,Matches
68,67,Yannick Carrasco,"DF,FW",be Belgium,30-309,1993,2.4,4,2,0,4,0,3,7,42.9,4,0,0,0,0,4,3,0,Matches
69,68,Dani Carvajal,DF,es Spain,32-180,1992,4.2,5,2,3,0,2,2,6,33.3,4,5,2,3,6,11,5,0,Matches
70,69,Timothy Castagne,DF,be Belgium,28-217,1995,4.0,1,1,0,1,0,0,2,0.0,2,5,2,3,2,3,14,0,Matches
71,70,Koen Casteels,GK,be Belgium,32-014,1992,4.0,0,0,0,0,0,0,0,,0,0,0,0,0,0,2,0,Matches
72,71,Žan Celar,"FW,MF",si Slovenia,25-117,1999,0.7,1,1,0,1,0,1,1,100.0,0,0,0,0,1,2,2,0,Matches
73,72,Zeki Çelik,"DF,MF",tr Türkiye,27-143,1997,1.2,3,0,2,1,0,3,4,75.0,1,1,0,1,0,3,0,0,Matches
74,73,Václav Černý,MF,cz Czechia,26-266,1997,0.6,1,1,1,0,0,1,3,33.3,2,1,0,1,0,1,1,0,Matches
75,74,Giorgi Chakvetadze,"MF,FW",ge Georgia,24-315,1999,2.7,10,5,7,2,1,6,9,66.7,3,7,2,5,1,11,3,0,Matches
76,75,Federico Chiesa,"FW,MF",it Italy,26-258,1997,2.9,6,4,4,1,1,3,5,60.0,2,0,0,0,3,9,2,0,Matches
78,76,Tomáš Chorý,MF,cz Czechia,29-165,1995,0.4,0,0,0,0,0,0,0,,0,0,0,0,0,0,0,0,Matches
79,77,Andreas Christensen,DF,dk Denmark,28-090,1996,3.9,4,2,4,0,0,3,3,100.0,0,3,1,2,6,10,11,0,Matches
80,78,Ryan Christie,"MF,FW",sct Scotland,29-138,1995,1.1,0,0,0,0,0,0,0,,0,0,0,0,0,0,1,0,Matches
81,79,Mojmir Chytil,FW,cz Czechia,25-071,1999,1.2,0,0,0,0,0,0,0,,0,2,0,2,0,0,2,0,Matches
82,80,Alexandru Cicâldău,MF,ro Romania,27-001,1997,0.2,2,0,2,0,0,1,1,100.0,0,1,0,1,0,2,0,0,Matches
83,81,Florinel Coman,MF,ro Romania,26-090,1998,1.3,1,1,1,0,0,0,0,,0,1,0,1,1,2,2,0,Matches
84,82,Kingsley Coman,MF,fr France,28-026,1996,0.2,0,0,0,0,0,0,0,,0,0,0,0,0,0,0,0,Matches
85,83,Francisco Conceição,"FW,MF",pt Portugal,21-208,2002,2.0,2,1,0,2,0,0,3,0.0,3,1,0,1,0,2,0,0,Matches
86,84,Diogo Costa,GK,pt Portugal,24-294,1999,5.7,0,0,0,0,0,0,0,,0,0,0,0,0,0,2,0,Matches
87,85,Vladimír Coufal,"DF,FW",cz Czechia,31-322,1992,3.0,5,4,4,1,0,4,9,44.4,5,7,6,1,2,7,13,0,Matches
88,86,Bryan Cristante,MF,it Italy,29-128,1995,1.5,0,0,0,0,0,0,0,,0,1,1,0,2,2,1,0,Matches
89,87,Kevin Csoboth,DF,hu Hungary,24-019,2000,0.1,0,0,0,0,0,0,1,0.0,1,1,0,1,0,0,0,0,Matches
90,88,Marc Cucurella,DF,es Spain,25-353,1998,4.1,11,8,2,6,3,4,7,57.1,3,7,3,4,6,17,7,0,Matches
91,89,Mirlind Daku,FW,al Albania,26-190,1998,0.1,1,0,0,0,1,0,0,,0,0,0,0,0,1,0,0,Matches
92,90,Diogo Dalot,"DF,MF",pt Portugal,25-113,1999,1.7,1,1,1,0,0,0,0,,0,2,1,1,1,2,1,0,Matches
93,91,Mikkel Damsgaard,FW,dk Denmark,24-006,2000,0.4,1,1,1,0,0,0,0,,0,1,0,1,1,2,1,0,Matches
94,92,Kevin Danso,DF,at Austria,25-294,1998,2.4,0,0,0,0,0,0,1,0.0,1,4,3,1,0,0,13,0,Matches
95,93,Márton Dárdai,DF,hu Hungary,22-148,2002,1.9,4,1,4,0,0,2,5,40.0,3,2,0,2,0,4,3,0,Matches
96,94,Matteo Darmian,DF,it Italy,34-220,1989,1.8,1,1,1,0,0,1,2,50.0,1,4,3,1,1,2,6,0,Matches
97,95,Zuriko Davitashvili,"FW,MF",ge Georgia,23-145,2001,1.3,4,3,2,0,2,2,3,66.7,1,3,0,3,0,4,1,0,Matches
98,96,Paweł Dawidowicz,DF,pl Poland,29-050,1995,2.0,1,0,1,0,0,0,1,0.0,1,4,3,1,0,1,7,0,Matches
99,97,Kevin De Bruyne,MF,be Belgium,33-011,1991,4.0,5,1,3,0,2,1,3,33.3,2,2,0,2,0,5,2,0,Matches
100,98,Charles De Ketelaere,FW,be Belgium,23-121,2001,0.0,0,0,0,0,0,0,0,,0,0,0,0,0,0,0,0,Matches
101,99,Zeno Debast,DF,be Belgium,20-259,2003,1.2,3,1,2,1,0,1,1,100.0,0,3,1,2,0,3,8,0,Matches
102,100,Thomas Delaney,MF,dk Denmark,32-310,1991,0.9,0,0,0,0,0,0,0,,0,0,0,0,2,2,2,0,Matches
104,101,Ousmane Dembélé,"FW,MF",fr France,27-055,1997,3.1,7,5,0,5,2,2,2,100.0,0,5,0,5,1,8,2,1,Matches
105,102,Merih Demiral,DF,tr Türkiye,26-126,1998,2.3,2,2,2,0,0,2,2,100.0,0,8,6,2,4,6,26,1,Matches
106,103,Giovanni Di Lorenzo,"DF,FW",it Italy,30-340,1993,4.0,13,9,9,3,1,7,12,58.3,5,4,1,3,6,19,6,1,Matches
107,104,Rúben Dias,DF,pt Portugal,27-056,1997,4.7,2,1,2,0,0,1,3,33.3,2,7,4,3,3,5,12,0,Matches
108,105,Federico Dimarco,"DF,FW",it Italy,26-242,1997,2.5,4,2,0,2,2,2,2,100.0,0,4,2,2,2,6,2,1,Matches
109,106,Berat Djimsiti,DF,al Albania,31-141,1993,3.0,1,0,1,0,0,0,1,0.0,1,8,5,3,2,3,16,0,Matches
110,107,Jeremy Doku,"FW,MF",be Belgium,22-043,2002,3.6,3,2,3,0,0,1,4,25.0,3,1,0,1,1,4,1,1,Matches
111,108,Kasper Dolberg,FW,dk Denmark,26-277,1997,0.4,1,1,0,1,0,0,0,,0,0,0,0,0,1,0,0,Matches
112,109,Gianluigi Donnarumma,GK,it Italy,25-135,1999,4.0,0,0,0,0,0,0,0,,0,0,0,0,0,0,2,0,Matches
113,110,David Doudera,FW,cz Czechia,26-039,1998,1.0,3,2,3,0,0,3,4,75.0,1,1,0,1,0,3,2,0,Matches
114,111,Artem Dovbyk,FW,ua Ukraine,27-018,1997,2.7,2,2,0,0,2,0,0,,0,0,0,0,1,3,2,0,Matches
115,112,Denis Drăguș,FW,ro Romania,25-003,1999,3.2,2,1,1,0,1,0,5,0.0,5,4,1,3,1,3,8,0,Matches
116,113,Radu Drăgușin,DF,ro Romania,22-157,2002,4.0,1,1,1,0,0,1,3,33.3,2,6,4,2,6,7,33,0,Matches
117,114,Vanja Drkušič,DF,si Slovenia,24-253,1999,4.3,12,7,11,1,0,11,13,84.6,2,3,2,1,1,13,16,0,Matches
118,115,Kwadwo Duah,FW,ch Switzerland,27-136,1997,1.2,1,1,0,0,1,1,1,100.0,0,0,0,0,1,2,0,0,Matches
119,116,Martin Dúbravka,GK,sk Slovakia,35-176,1989,4.3,0,0,0,0,0,0,0,,0,1,0,1,1,1,3,1,Matches
120,117,Ondrej Duda,MF,sk Slovakia,29-217,1994,3.5,7,3,2,4,1,4,6,66.7,2,8,3,5,3,10,5,0,Matches
121,118,Denzel Dumfries,DF,nl Netherlands,28-082,1996,4.0,6,4,4,0,2,3,5,60.0,2,4,1,3,3,9,4,0,Matches
122,119,Dávid Ďuriš,"FW,MF",sk Slovakia,25-109,1999,0.3,0,0,0,0,0,0,0,,0,0,0,0,0,0,0,0,Matches
123,120,Lasha Dvali,DF,ge Georgia,29-056,1995,4.0,8,3,7,1,0,4,7,57.1,3,6,5,1,1,9,24,0,Matches
124,121,Timi Elšnik,MF,si Slovenia,26-071,1998,4.0,13,7,7,4,2,5,7,71.4,2,6,3,3,4,17,5,0,Matches
125,122,Breel Embolo,FW,ch Switzerland,27-146,1997,3.3,3,3,0,2,1,0,0,,0,3,0,3,1,4,3,0,Matches
126,123,Christian Eriksen,"MF,FW",dk Denmark,32-146,1992,3.9,6,2,1,3,2,3,4,75.0,1,3,0,3,2,8,2,0,Matches
127,124,Eberechi Eze,"DF,MF",eng England,26-010,1998,1.1,0,0,0,0,0,0,0,,0,0,0,0,0,0,3,0,Matches
128,125,Wout Faes,DF,be Belgium,26-097,1998,4.0,10,7,5,5,0,3,3,100.0,0,5,3,2,4,14,11,2,Matches
130,126,Nicolò Fagioli,MF,it Italy,23-148,2001,1.1,3,1,2,0,1,1,2,50.0,1,1,1,0,0,3,0,0,Matches
131,127,João Félix,"MF,FW",pt Portugal,24-242,1999,1.2,0,0,0,0,0,0,4,0.0,4,0,0,0,0,0,0,0,Matches
132,128,Bruno Fernandes,MF,pt Portugal,29-305,1994,4.2,8,5,5,3,0,2,3,66.7,1,6,1,5,2,10,2,0,Matches
133,129,Attila Fiola,DF,hu Hungary,34-143,1990,2.0,3,1,2,0,1,2,2,100.0,0,1,1,0,0,3,9,0,Matches
134,130,Phil Foden,"FW,MF",eng England,24-042,2000,5.0,4,2,2,2,0,1,3,33.3,2,5,0,5,1,5,2,0,Matches
135,131,Youssouf Fofana,MF,fr France,25-181,1999,0.5,1,1,1,0,0,0,3,0.0,3,0,0,0,1,2,1,0,Matches
136,132,Michael Folorunsho,FW,it Italy,26-153,1998,0.0,0,0,0,0,0,0,0,,0,0,0,0,0,0,0,0,Matches
137,133,Przemysław Frankowski,DF,pl Poland,29-088,1995,3.0,7,5,6,0,1,3,12,25.0,9,1,0,1,1,8,12,0,Matches
138,134,Davide Frattesi,MF,it Italy,24-261,1999,2.1,2,1,1,1,0,1,2,50.0,1,0,0,0,0,2,1,0,Matches
139,135,Remo Freuler,MF,ch Switzerland,32-085,1992,5.1,8,5,3,3,2,1,7,14.3,6,8,0,8,4,12,10,0,Matches
140,136,Jeremie Frimpong,FW,nl Netherlands,23-212,2000,1.0,0,0,0,0,0,0,1,0.0,1,0,0,0,0,0,1,0,Matches
141,137,Chris Führich,FW,de Germany,26-182,1998,0.2,1,1,0,0,1,1,1,100.0,0,2,0,2,0,1,0,0,Matches
142,138,Niclas Füllkrug,FW,de Germany,31-151,1993,1.8,1,0,0,0,1,1,1,100.0,0,0,0,0,0,1,3,0,Matches
143,139,Mijat Gaćinović,DF,rs Serbia,29-152,1995,0.5,1,1,1,0,0,1,2,50.0,1,2,0,2,0,1,0,0,Matches
144,140,Cody Gakpo,FW,nl Netherlands,25-063,1999,4.8,9,8,3,4,2,2,11,18.2,9,4,0,4,2,11,5,0,Matches
145,141,Conor Gallagher,MF,eng England,24-154,2000,1.3,1,0,1,0,0,0,2,0.0,2,3,1,2,0,1,4,1,Matches
146,142,Dániel Gazdag,MF,hu Hungary,28-129,1996,0.0,1,1,1,0,0,0,0,,0,0,0,0,0,1,0,0,Matches
147,143,Lutsharel Geertruida,DF,nl Netherlands,23-357,2000,1.2,4,3,3,1,0,0,0,,0,2,0,2,0,4,0,0,Matches
148,144,Billy Gilmour,MF,sct Scotland,23-028,2001,2.0,1,1,0,1,0,0,0,,0,2,0,2,0,1,2,0,Matches
149,145,Olivier Giroud,FW,fr France,37-283,1986,0.5,0,0,0,0,0,0,0,,0,0,0,0,0,0,0,0,Matches
150,146,Klaus Gjasula,MF,al Albania,34-208,1989,0.2,0,0,0,0,0,0,2,0.0,2,1,0,1,0,0,0,0,Matches
151,147,Adam Gnezda Čerin,MF,si Slovenia,24-359,1999,4.3,9,5,8,1,0,4,9,44.4,5,7,0,7,5,14,10,0,Matches
152,148,Anthony Gordon,FW,eng England,23-136,2001,0.0,0,0,0,0,0,0,0,,0,0,0,0,0,0,0,0,Matches
153,149,Jon Gorenc Stanković,MF,si Slovenia,28-177,1996,1.0,1,1,1,0,0,0,1,0.0,1,3,3,0,0,1,2,0,Matches
154,150,Michael Gregoritsch,FW,at Austria,30-082,1994,1.4,1,1,0,1,0,1,2,50.0,1,1,0,1,0,1,0,0,Matches
156,151,Antoine Griezmann,"MF,FW",fr France,33-110,1991,4.1,5,3,2,2,1,4,6,66.7,2,4,0,4,1,6,2,1,Matches
157,152,Florian Grillitsch,MF,at Austria,28-337,1995,2.2,2,1,1,0,1,1,3,33.3,2,0,0,0,6,8,0,0,Matches
158,153,Álex Grimaldo,DF,es Spain,28-293,1995,1.3,1,1,1,0,0,1,2,50.0,1,1,0,1,3,4,4,0,Matches
159,154,Pascal Groß,MF,de Germany,33-024,1991,0.5,1,1,0,1,0,0,0,,0,0,0,0,0,1,0,0,Matches
160,155,Kamil Grosicki,MF,pl Poland,36-031,1988,0.2,0,0,0,0,0,0,0,,0,1,0,1,0,0,0,0,Matches
161,156,Nemanja Gudelj,MF,rs Serbia,32-236,1991,1.0,1,0,1,0,0,1,1,100.0,0,0,0,0,1,2,1,0,Matches
162,157,Marc Guéhi,DF,eng England,23-362,2000,4.3,2,2,0,1,1,0,1,0.0,1,6,3,3,2,4,7,0,Matches
163,158,Péter Gulácsi,GK,hu Hungary,34-064,1990,3.0,0,0,0,0,0,0,1,0.0,1,0,0,0,0,0,3,0,Matches
164,159,Arda Güler,"FW,MF",tr Türkiye,19-135,2005,3.8,9,5,5,2,2,7,11,63.6,4,0,0,0,3,12,0,0,Matches
165,160,İlkay Gündoğan,MF,de Germany,33-259,1990,4.3,5,4,1,3,1,0,2,0.0,2,0,0,0,1,6,0,0,Matches
166,161,Angus Gunn,GK,sct Scotland,28-169,1996,3.0,0,0,0,0,0,0,0,,0,0,0,0,0,0,4,0,Matches
167,162,Mert Günok,GK,tr Türkiye,35-130,1989,4.0,0,0,0,0,0,0,0,,0,0,0,0,0,0,1,2,Matches
168,163,Joško Gvardiol,DF,hr Croatia,22-168,2002,3.0,5,3,3,1,1,2,4,50.0,2,2,1,1,5,10,4,0,Matches
169,164,Giorgi Gwelesiani,DF,ge Georgia,33-065,1991,1.8,3,3,3,0,0,3,5,60.0,2,3,3,0,2,5,15,1,Matches
170,165,Norbert Gyömbér,DF,sk Slovakia,32-006,1992,0.4,0,0,0,0,0,0,0,,0,0,0,0,1,1,2,0,Matches
171,166,Ianis Hagi,MF,ro Romania,25-261,1998,2.1,5,3,2,1,2,2,4,50.0,2,1,0,1,0,5,4,0,Matches
172,167,Dávid Hancko,DF,sk Slovakia,26-209,1997,4.1,10,5,6,4,0,4,11,36.4,7,7,2,5,3,13,10,0,Matches
173,168,Grant Hanley,DF,sct Scotland,32-232,1991,2.5,2,0,1,1,0,0,0,,0,2,1,1,1,3,11,0,Matches
174,169,Lukáš Haraslín,FW,sk Slovakia,28-044,1996,2.9,4,4,2,1,1,4,6,66.7,2,1,0,1,3,7,5,0,Matches
175,170,Kai Havertz,"FW,MF",de Germany,25-028,1999,4.3,2,1,1,1,0,2,2,100.0,0,4,0,4,0,2,8,0,Matches
176,171,Jack Hendry,DF,sct Scotland,29-063,1995,2.9,2,1,1,1,0,2,2,100.0,0,2,2,0,1,3,10,0,Matches
177,172,Benjamin Henrichs,DF,de Germany,27-137,1997,0.1,0,0,0,0,0,0,0,,0,0,0,0,0,0,0,0,Matches
178,173,Theo Hernández,DF,fr France,26-277,1997,5.3,8,4,6,2,0,5,8,62.5,3,5,4,1,3,11,11,2,Matches
179,174,Morten Hjulmand,MF,dk Denmark,25-014,1999,2.7,3,1,1,2,0,2,5,40.0,3,3,1,2,1,4,3,1,Matches
180,175,Adam Hložek,MF,cz Czechia,21-350,2002,1.2,1,0,0,0,1,0,1,0.0,1,0,0,0,1,2,1,0,Matches
182,176,Tomáš Holeš,DF,cz Czechia,31-100,1993,3.0,10,5,5,3,2,7,10,70.0,3,4,2,2,2,12,12,0,Matches
183,177,Arbër Hoxha,"FW,MF",al Albania,25-277,1998,0.6,2,2,1,1,0,2,2,100.0,0,0,0,0,0,2,0,0,Matches
184,178,Robin Hranáč,DF,cz Czechia,24-162,2000,3.0,2,1,1,1,0,2,2,100.0,0,3,1,2,0,2,12,1,Matches
185,179,Elseid Hysaj,DF,al Albania,30-140,1994,2.0,1,1,0,1,0,1,5,20.0,4,3,2,1,0,1,2,0,Matches
186,180,Pierre Højbjerg,MF,dk Denmark,28-339,1995,3.9,10,7,5,5,0,7,13,53.8,6,5,0,5,3,13,5,0,Matches
187,181,Rasmus Højlund,FW,dk Denmark,21-156,2003,3.2,3,1,0,1,2,1,4,25.0,3,0,0,0,1,4,1,0,Matches
188,182,Ivan Ilić,MF,rs Serbia,23-114,2001,2.2,6,4,4,1,1,3,3,100.0,0,4,3,1,0,6,3,1,Matches
189,183,Josip Iličić,"FW,MF",si Slovenia,36-162,1988,0.3,2,1,1,0,1,1,1,100.0,0,0,0,0,0,2,0,0,Matches
190,184,Gonçalo Inácio,DF,pt Portugal,22-319,2001,1.3,2,2,1,1,0,2,5,40.0,3,6,0,6,1,3,5,0,Matches
191,185,Luka Ivanušec,MF,hr Croatia,25-226,1998,0.2,0,0,0,0,0,0,0,,0,0,0,0,0,0,1,0,Matches
192,186,Erik Janža,DF,si Slovenia,31-018,1993,3.0,4,4,3,1,0,1,5,20.0,4,1,1,0,2,6,8,0,Matches
193,187,Jorginho,MF,it Italy,32-202,1991,2.4,6,2,6,0,0,3,8,37.5,5,3,0,3,4,10,1,0,Matches
194,188,Joselu,FW,es Spain,34-104,1990,1.0,0,0,0,0,0,0,1,0.0,1,1,0,1,0,0,3,0,Matches
195,189,Diogo Jota,"FW,MF",pt Portugal,27-218,1996,1.1,3,2,0,2,1,0,0,,0,1,0,1,0,3,0,0,Matches
196,190,Luka Jović,"MF,FW",rs Serbia,26-199,1997,1.1,0,0,0,0,0,0,0,,0,0,0,0,0,0,1,0,Matches
197,191,Josip Juranović,DF,hr Croatia,28-328,1995,1.0,3,3,1,2,0,2,3,66.7,1,1,1,0,1,4,1,0,Matches
198,192,David Jurásek,DF,cz Czechia,23-337,2000,1.8,3,2,2,1,0,2,5,40.0,3,1,1,0,1,4,2,0,Matches
199,193,Matěj Jurásek,"DF,MF",cz Czechia,20-314,2003,0.5,2,1,0,1,1,2,4,50.0,2,0,0,0,0,2,1,0,Matches
200,194,Ferdi Kadioglu,"DF,MF",tr Türkiye,24-276,1999,5.0,18,12,9,7,2,10,13,76.9,3,5,1,4,7,25,10,0,Matches
201,195,İrfan Kahveci,FW,tr Türkiye,28-360,1995,0.1,0,0,0,0,0,0,0,,0,0,0,0,0,0,0,0,Matches
202,196,Otar Kakabadze,"DF,MF",ge Georgia,29-012,1995,4.0,12,8,10,1,1,10,18,55.6,8,3,1,2,4,16,8,0,Matches
203,197,Harry Kane,FW,eng England,30-347,1993,5.1,4,3,2,2,0,1,2,50.0,1,1,1,0,1,5,0,0,Matches
204,198,N'Golo Kanté,MF,fr France,33-102,1991,5.0,11,8,6,2,3,4,5,80.0,1,5,1,4,5,16,6,0,Matches
205,199,Žan Karničnik,DF,si Slovenia,29-295,1994,4.3,8,4,7,1,0,7,12,58.3,5,5,3,2,8,16,11,0,Matches
206,200,Guram Kashia,DF,ge Georgia,37-005,1987,4.0,7,4,5,2,0,4,4,100.0,0,13,12,1,1,8,31,1,Matches
208,201,Milos Kerkez,DF,hu Hungary,20-245,2003,2.6,4,2,3,1,0,3,5,60.0,2,0,0,0,0,4,7,1,Matches
209,202,Semih Kılıçsoy,FW,tr Türkiye,18-329,2005,0.0,0,0,0,0,0,0,0,,0,0,0,0,0,0,0,0,Matches
210,203,Joshua Kimmich,DF,de Germany,29-152,1995,5.3,7,4,5,0,2,4,12,33.3,8,6,2,4,6,13,6,0,Matches
211,204,Otar Kiteishvili,MF,ge Georgia,28-105,1996,1.4,4,4,4,0,0,2,6,33.3,4,3,1,2,0,4,3,0,Matches
212,205,Jakub Kiwior,DF,pl Poland,24-145,2000,3.0,7,4,6,1,0,3,5,60.0,2,4,2,2,5,12,9,0,Matches
213,206,László Kleinheisler,MF,hu Hungary,30-092,1994,0.6,0,0,0,0,0,0,1,0.0,1,0,0,0,0,0,0,0,Matches
214,207,Giorgi Kochorashvili,MF,ge Georgia,25-010,1999,4.0,9,5,5,4,0,5,6,83.3,1,6,4,2,5,14,6,1,Matches
215,208,Orkun Kökçü,MF,tr Türkiye,23-193,2000,2.5,3,2,2,0,1,1,4,25.0,3,3,1,2,1,4,2,0,Matches
216,209,Randal Kolo Muani,FW,fr France,25-217,1998,1.5,1,0,1,0,0,1,1,100.0,0,2,1,1,1,2,3,0,Matches
217,210,Yukhym Konoplia,DF,ua Ukraine,24-318,1999,0.8,1,0,0,0,1,0,0,,0,1,0,1,0,1,0,0,Matches
218,211,Ezri Konsa,DF,eng England,26-260,1997,1.0,2,0,2,0,0,1,1,100.0,0,3,2,1,0,2,8,0,Matches
219,212,Filip Kostić,DF,rs Serbia,31-251,1992,0.5,1,0,1,0,0,1,2,50.0,1,1,0,1,0,1,1,0,Matches
220,213,Jules Koundé,DF,fr France,25-240,1998,5.3,15,9,6,4,5,9,15,60.0,6,3,0,3,0,15,21,0,Matches
221,214,Mateo Kovačić,MF,hr Croatia,30-064,1994,2.5,8,6,2,5,1,2,5,40.0,3,2,1,1,3,11,0,0,Matches
222,215,Matej Kovar,GK,cz Czechia,24-053,2000,0.4,0,0,0,0,0,0,0,,0,0,0,0,0,0,0,0,Matches
223,216,Andrej Kramarić,FW,hr Croatia,33-020,1991,2.7,0,0,0,0,0,0,0,,0,3,1,2,1,1,1,0,Matches
224,217,Ladislav Krejčí,DF,cz Czechia,25-080,1999,3.0,3,2,3,0,0,0,3,0.0,3,1,1,0,5,8,9,0,Matches
225,218,Toni Kroos,MF,de Germany,34-187,1990,5.2,9,4,4,4,1,3,5,60.0,2,3,0,3,7,16,5,0,Matches
226,219,Jan Kuchta,FW,cz Czechia,27-183,1997,1.1,2,1,2,0,0,1,1,100.0,0,0,0,0,0,2,2,0,Matches
227,220,Juraj Kucka,MF,sk Slovakia,37-134,1987,3.9,1,1,0,1,0,1,7,14.3,6,3,1,2,2,3,4,0,Matches
228,221,Jasmin Kurtić,FW,si Slovenia,35-181,1989,0.0,0,0,0,0,0,0,0,,0,0,0,0,0,0,0,0,Matches
229,222,Khvicha Kvaratskhelia,FW,ge Georgia,23-148,2001,3.8,4,3,0,4,0,3,6,50.0,3,2,2,0,0,4,2,0,Matches
230,223,Nika Kvekveskiri,MF,ge Georgia,32-041,1992,0.1,0,0,0,0,0,0,1,0.0,1,0,0,0,1,1,0,0,Matches
231,224,Giorgi Kvilitaia,FW,ge Georgia,30-282,1993,0.0,0,0,0,0,0,0,0,,0,0,0,0,0,0,0,0,Matches
232,225,Solomon Kvirkvelia,DF,ge Georgia,32-154,1992,2.0,4,3,3,1,0,3,3,100.0,0,2,2,0,1,5,17,1,Matches
234,226,Qazim Laçi,"MF,FW",al Albania,28-172,1996,1.8,4,3,1,2,1,1,2,50.0,1,3,0,3,3,7,5,0,Matches
235,227,Konrad Laimer,"MF,FW",at Austria,27-043,1997,3.0,5,1,2,1,2,3,6,50.0,3,3,0,3,2,7,2,0,Matches
236,228,Ádám Lang,DF,hu Hungary,31-174,1993,0.5,0,0,0,0,0,0,0,,0,0,0,0,1,1,3,0,Matches
237,229,Aymeric Laporte,DF,es Spain,30-043,1994,3.8,3,3,2,1,0,2,3,66.7,1,2,2,0,4,7,16,1,Matches
238,230,Robin Le Normand,DF,es Spain,27-241,1996,4.0,6,2,5,1,0,5,8,62.5,3,2,1,1,2,8,11,0,Matches
239,231,Rafael Leão,FW,pt Portugal,25-029,1999,3.2,2,2,2,0,0,1,2,50.0,1,1,0,1,1,3,1,0,Matches
240,232,Robert Lewandowski,FW,pl Poland,35-323,1988,1.3,2,2,0,0,2,0,0,,0,2,0,2,0,2,3,0,Matches
241,233,Philipp Lienhart,DF,at Austria,27-364,1996,2.4,2,2,1,1,0,2,3,66.7,1,2,2,0,2,4,10,0,Matches
242,234,Ondřej Lingr,"MF,FW",cz Czechia,25-276,1998,0.9,2,2,0,2,0,0,1,0.0,1,1,0,1,0,2,0,0,Matches
243,235,Dominik Livaković,GK,hr Croatia,29-182,1995,3.0,0,0,0,0,0,0,0,,0,0,0,0,1,1,2,0,Matches
244,236,Stanislav Lobotka,MF,sk Slovakia,29-227,1994,4.3,7,6,3,4,0,2,6,33.3,4,3,0,3,3,10,9,0,Matches
245,237,Saba Lobzhanidze,FW,ge Georgia,29-204,1994,0.1,0,0,0,0,0,0,0,,0,0,0,0,0,0,3,0,Matches
246,238,Luka Lochoshvili,"DF,MF",ge Georgia,26-041,1998,1.9,4,3,3,0,1,3,5,60.0,2,1,0,1,3,7,11,0,Matches
247,239,Fermin López,MF,es Spain,21-059,2003,0.3,1,1,0,0,1,0,1,0.0,1,0,0,0,0,1,0,0,Matches
248,240,Romelu Lukaku,FW,be Belgium,31-057,1993,4.0,0,0,0,0,0,0,0,,0,0,0,0,0,0,3,0,Matches
249,241,Dodi Lukebakio,"FW,DF",be Belgium,26-289,1997,0.7,1,1,0,0,1,0,0,,0,1,0,1,0,1,0,0,Matches
250,242,Saša Lukić,MF,rs Serbia,27-331,1996,2.3,8,5,1,5,2,5,6,83.3,1,2,0,2,3,11,5,0,Matches
251,243,Andriy Lunin,GK,ua Ukraine,25-149,1999,1.0,0,0,0,0,0,0,0,,0,0,0,0,0,0,0,2,Matches
252,244,Mike Maignan,GK,fr France,29-006,1995,5.3,0,0,0,0,0,0,0,,0,0,0,0,0,0,5,0,Matches
253,245,Kobbie Mainoo,MF,eng England,19-081,2005,2.3,4,3,0,4,0,1,2,50.0,1,0,0,0,4,8,1,0,Matches
254,246,Lovro Majer,"FW,MF",hr Croatia,26-174,1998,1.6,4,3,1,2,1,2,2,100.0,0,4,0,4,0,4,0,0,Matches
255,247,Donyell Malen,FW,nl Netherlands,25-182,1999,1.6,0,0,0,0,0,0,0,,0,0,0,0,1,1,1,0,Matches
256,248,Ruslan Malinovskyi,MF,ua Ukraine,31-066,1993,0.4,5,1,1,4,0,1,3,33.3,2,1,0,1,1,6,3,0,Matches
257,249,Giorgi Mamardashvili,GK,ge Georgia,23-284,2000,4.0,0,0,0,0,0,0,0,,0,0,0,0,0,0,2,0,Matches
258,250,Dennis Man,MF,ro Romania,25-318,1998,3.0,3,0,1,2,0,2,4,50.0,2,0,0,0,1,4,0,0,Matches
260,251,Rey Manaj,FW,al Albania,27-136,1997,1.7,2,2,1,0,1,0,1,0.0,1,0,0,0,1,3,2,0,Matches
261,252,Gianluca Mancini,DF,it Italy,28-083,1996,1.0,0,0,0,0,0,0,0,,0,3,1,2,0,0,1,0,Matches
262,253,Orel Mangala,MF,be Belgium,26-113,1998,1.5,4,3,2,1,1,1,3,33.3,2,2,1,1,4,8,0,0,Matches
263,254,Marius Marin,MF,ro Romania,25-314,1998,3.4,9,3,8,1,0,5,10,50.0,5,4,1,3,4,13,6,0,Matches
264,255,Răzvan Marin,MF,ro Romania,28-047,1996,3.9,7,2,3,4,0,4,9,44.4,5,3,2,1,0,7,6,0,Matches
265,256,Ádám Martin,"FW,DF",hu Hungary,29-246,1994,0.5,0,0,0,0,0,0,0,,0,2,2,0,0,0,0,0,Matches
266,257,Mykola Matviyenko,DF,ua Ukraine,28-068,1996,3.0,4,3,2,2,0,2,4,50.0,2,4,2,2,4,8,9,1,Matches
267,258,Kylian Mbappé,FW,fr France,25-202,1998,4.2,1,0,1,0,0,0,2,0.0,2,4,1,3,0,1,0,0,Matches
268,259,John McGinn,"MF,FW",sct Scotland,29-265,1994,2.6,1,1,0,1,0,1,4,25.0,3,2,0,2,1,2,0,0,Matches
269,260,Callum McGregor,MF,sct Scotland,31-025,1993,2.7,2,1,1,1,0,1,4,25.0,3,2,1,1,2,4,6,0,Matches
270,261,Scott McKenna,DF,sct Scotland,27-240,1996,1.5,1,0,1,0,0,1,2,50.0,1,1,1,0,2,3,5,0,Matches
271,262,Kenny McLean,MF,sct Scotland,32-183,1992,0.5,3,2,1,2,0,3,3,100.0,0,0,0,0,0,3,0,0,Matches
272,263,Scott McTominay,MF,sct Scotland,27-214,1996,3.0,4,2,2,1,1,1,2,50.0,1,2,1,1,3,7,7,0,Matches
273,264,Anzor Mekvabishvili,MF,ge Georgia,23-034,2001,2.1,6,3,3,3,0,3,3,100.0,0,4,1,3,5,11,5,0,Matches
274,265,Memphis,"FW,MF",nl Netherlands,30-147,1994,4.7,1,1,0,1,0,1,4,25.0,3,1,0,1,1,2,1,0,Matches
275,266,Nuno Mendes,DF,pt Portugal,22-020,2002,4.7,12,6,7,3,2,6,11,54.5,5,6,2,4,5,17,11,0,Matches
276,267,Mikel Merino,"MF,FW",es Spain,28-017,1996,1.8,4,3,0,3,1,2,3,66.7,1,2,1,1,2,6,4,0,Matches
277,268,Valentin Mihaila,MF,ro Romania,24-158,2000,1.3,3,2,2,0,1,0,1,0.0,1,0,0,0,2,5,5,0,Matches
278,269,Srđan Mijailović,DF,rs Serbia,30-242,1993,0.8,3,1,1,2,0,3,4,75.0,1,1,0,1,1,4,4,0,Matches
279,270,Georges Mikautadze,FW,ge Georgia,23-252,2000,3.8,3,1,1,2,0,1,4,25.0,3,0,0,0,0,3,0,0,Matches
280,271,Nikola Milenković,DF,rs Serbia,26-271,1997,3.0,3,3,1,2,0,1,2,50.0,1,2,2,0,2,5,11,0,Matches
281,272,Sergej Milinković-Savić,MF,rs Serbia,29-133,1995,1.3,2,2,0,2,0,1,2,50.0,1,1,1,0,1,3,2,0,Matches
282,273,Mario Mitaj,DF,al Albania,20-338,2003,3.0,8,4,6,1,1,8,11,72.7,3,4,0,4,7,15,11,0,Matches
283,274,Aleksandar Mitrović,FW,rs Serbia,29-297,1994,2.7,0,0,0,0,0,0,1,0.0,1,2,0,2,0,0,4,0,Matches
284,275,Maximilian Mittelstädt,DF,de Germany,27-113,1997,3.4,4,2,1,1,2,3,5,60.0,2,6,0,6,2,6,8,0,Matches
286,276,Filip Mladenović,DF,rs Serbia,32-329,1991,1.2,2,1,0,1,1,1,5,20.0,4,0,0,0,2,4,1,0,Matches
287,277,Jan Mlakar,MF,si Slovenia,25-260,1998,3.3,3,3,2,1,0,1,2,50.0,1,2,1,1,1,4,9,0,Matches
288,278,Jakub Moder,MF,pl Poland,25-093,1999,2.0,2,2,0,2,0,1,3,33.3,2,3,1,2,1,3,8,0,Matches
289,279,Luka Modrić,MF,hr Croatia,38-304,1985,2.6,4,4,4,0,0,1,2,50.0,1,1,0,1,1,5,1,0,Matches
290,280,Vasile Mogos,DF,ro Romania,31-252,1992,0.4,0,0,0,0,0,0,1,0.0,1,0,0,0,0,0,1,0,Matches
291,281,Álvaro Morata,FW,es Spain,31-260,1992,3.4,5,3,1,1,3,0,2,0.0,2,0,0,0,0,5,1,0,Matches
292,282,Lewis Morgan,DF,sct Scotland,27-283,1996,0.0,0,0,0,0,0,0,0,,0,0,0,0,1,1,0,0,Matches
293,283,Ernest Muçi,FW,al Albania,23-112,2001,0.2,0,0,0,0,0,0,0,,0,0,0,0,0,0,0,0,Matches
294,284,Mykhailo Mudryk,"FW,MF",ua Ukraine,23-186,2001,1.9,2,2,1,0,1,2,4,50.0,2,0,0,0,0,2,1,1,Matches
295,285,Mert Müldür,"DF,MF",tr Türkiye,25-097,1999,3.8,7,6,3,1,3,7,9,77.8,2,8,1,7,5,12,12,0,Matches
296,286,Thomas Müller,"MF,FW",de Germany,34-300,1989,0.6,2,1,1,1,0,1,2,50.0,1,0,0,0,0,2,1,0,Matches
297,287,Jamal Musiala,FW,de Germany,21-134,2003,4.7,6,4,1,4,1,2,3,66.7,1,7,0,7,4,10,2,0,Matches
298,288,Phillipp Mwene,DF,at Austria,30-162,1994,2.2,6,4,3,3,0,3,6,50.0,3,5,2,3,0,6,6,0,Matches
299,289,Vitaliy Mykolenko,DF,ua Ukraine,25-041,1999,0.6,0,0,0,0,0,0,0,,0,2,1,1,0,0,1,0,Matches
300,290,Joakim Mæhle,"DF,MF",dk Denmark,27-050,1997,3.1,6,4,3,2,1,3,8,37.5,5,2,0,2,3,9,5,1,Matches
301,291,Nacho,DF,es Spain,34-173,1990,1.8,1,1,0,1,0,0,1,0.0,1,1,1,0,0,1,10,0,Matches
302,292,Ádám Nagy,MF,hu Hungary,29-022,1995,1.8,3,2,2,1,0,2,2,100.0,0,1,0,1,4,7,3,0,Matches
303,293,Zsolt Nagy,DF,hu Hungary,31-045,1993,0.2,2,0,1,1,0,0,0,,0,0,0,0,0,2,2,0,Matches
304,294,Jesús Navas,DF,es Spain,38-231,1985,1.1,3,2,1,2,0,0,0,,0,2,0,2,1,4,6,0,Matches
305,295,Dan Ndoye,"MF,DF",ch Switzerland,23-258,2000,4.5,5,3,4,1,0,1,2,50.0,1,3,0,3,2,7,2,0,Matches
306,296,Pedro Neto,"DF,FW",pt Portugal,24-122,2000,1.3,5,1,2,2,1,2,2,100.0,0,0,0,0,2,7,1,0,Matches
307,297,Manuel Neuer,GK,de Germany,38-104,1986,5.3,0,0,0,0,0,0,0,,0,0,0,0,0,0,1,1,Matches
308,298,João Neves,MF,pt Portugal,19-286,2004,0.9,0,0,0,0,0,0,0,,0,1,0,1,5,5,0,0,Matches
309,299,Rúben Neves,MF,pt Portugal,27-118,1997,1.4,3,1,0,2,1,0,1,0.0,1,3,1,2,1,4,1,0,Matches
310,300,Florin Niță,GK,ro Romania,37-006,1987,4.0,0,0,0,0,0,0,0,,0,0,0,0,0,0,2,0,Matches
312,301,Matheus Nunes,MF,pt Portugal,25-317,1998,0.2,0,0,0,0,0,0,0,,0,0,0,0,0,0,0,0,Matches
313,302,Christian Nørgaard,MF,dk Denmark,30-121,1994,0.4,1,0,0,1,0,1,1,100.0,0,0,0,0,0,1,1,0,Matches
314,303,Adam Obert,DF,sk Slovakia,21-321,2002,0.3,1,1,0,1,0,1,1,100.0,0,0,0,0,0,1,1,0,Matches
315,304,Jan Oblak,GK,si Slovenia,31-184,1993,4.3,0,0,0,0,0,0,0,,0,0,0,0,0,0,1,0,Matches
316,305,Darius Olaru,MF,ro Romania,26-128,1998,0.3,0,0,0,0,0,0,0,,0,0,0,0,0,0,0,0,Matches
317,306,Dani Olmo,"MF,FW",es Spain,26-063,1998,3.0,2,2,1,0,1,2,4,50.0,2,1,0,1,2,4,2,0,Matches
318,307,Amadou Onana,MF,be Belgium,22-328,2001,4.0,8,6,3,4,1,4,5,80.0,1,7,1,6,3,11,4,2,Matches
319,308,Loïs Openda,FW,be Belgium,24-144,2000,0.8,2,1,0,0,2,0,0,,0,1,0,1,1,3,1,0,Matches
320,309,Willi Orban,DF,hu Hungary,31-249,1992,3.0,7,7,7,0,0,3,3,100.0,0,9,7,2,1,8,9,1,Matches
321,310,Mikel Oyarzabal,FW,es Spain,27-079,1997,1.8,1,0,0,0,1,0,0,,0,1,0,1,0,1,4,0,Matches
322,311,Salih Özcan,MF,tr Türkiye,26-180,1998,1.7,6,3,1,5,0,2,3,66.7,1,0,0,0,7,13,4,0,Matches
323,312,João Palhinha,MF,pt Portugal,29-000,1995,3.3,15,9,5,8,2,7,10,70.0,3,6,1,5,8,23,6,0,Matches
324,313,Cole Palmer,"MF,FW",eng England,22-064,2002,1.3,1,0,1,0,0,1,2,50.0,1,1,0,1,0,1,0,0,Matches
325,314,Mario Pašalić,"FW,MF",hr Croatia,29-151,1995,1.3,1,0,1,0,0,0,0,,0,0,0,0,0,1,2,0,Matches
326,315,Strahinja Pavlović,DF,rs Serbia,23-046,2001,3.0,11,6,7,3,1,9,14,64.3,5,2,0,2,4,15,10,0,Matches
327,316,Pedri,MF,es Spain,21-227,2002,2.1,6,3,1,4,1,2,4,50.0,2,0,0,0,1,7,0,0,Matches
328,317,Peter Pekarík,DF,sk Slovakia,37-253,1986,4.2,1,0,1,0,0,1,4,25.0,3,4,3,1,7,8,11,0,Matches
329,318,Lorenzo Pellegrini,"FW,MF",it Italy,28-020,1996,2.4,2,0,1,1,0,1,4,25.0,3,3,0,3,2,4,2,0,Matches
330,319,Patrick Pentz,GK,at Austria,27-189,1997,4.0,0,0,0,0,0,0,0,,0,0,0,0,0,0,3,1,Matches
331,320,Pepe,DF,pt Portugal,41-134,1983,4.5,9,5,5,3,1,7,13,53.8,6,3,2,1,5,14,26,1,Matches
332,321,Danilo Pereira,DF,pt Portugal,32-304,1991,1.0,0,0,0,0,0,0,0,,0,0,0,0,1,1,2,0,Matches
333,322,Ayoze Pérez,FW,es Spain,30-346,1993,0.1,0,0,0,0,0,0,0,,0,1,0,1,0,0,0,0,Matches
334,323,Ivan Perišić,"DF,FW",hr Croatia,35-158,1989,1.5,0,0,0,0,0,0,0,,0,1,0,1,1,1,3,0,Matches
335,324,Bruno Petković,FW,hr Croatia,29-297,1994,1.0,0,0,0,0,0,0,1,0.0,1,0,0,0,0,0,1,0,Matches
336,325,Krzysztof Piątek,FW,pl Poland,29-008,1995,0.7,1,1,0,1,0,0,0,,0,0,0,0,0,1,0,0,Matches
338,326,Jordan Pickford,GK,eng England,30-124,1994,5.7,0,0,0,0,0,0,0,,0,0,0,0,0,0,1,0,Matches
339,327,Jakub Piotrowski,MF,pl Poland,26-279,1997,0.6,0,0,0,0,0,0,0,,0,0,0,0,0,0,1,0,Matches
340,328,Marin Pongračić,DF,hr Croatia,26-302,1997,2.0,2,1,2,0,0,0,4,0.0,4,6,3,3,2,4,9,0,Matches
341,329,Ryan Porteous,DF,sct Scotland,25-106,1999,0.5,2,1,2,0,0,2,2,100.0,0,0,0,0,0,2,1,0,Matches
342,330,Stefan Posch,DF,at Austria,27-056,1997,4.0,15,9,4,8,3,9,13,69.2,4,11,4,7,6,21,11,0,Matches
343,331,Yussuf Poulsen,"FW,MF",dk Denmark,30-024,1994,0.6,1,0,0,0,1,1,2,50.0,1,1,0,1,0,1,1,0,Matches
344,332,Alexander Prass,DF,at Austria,23-044,2001,1.8,7,2,4,2,1,4,10,40.0,6,1,0,1,2,9,1,0,Matches
345,333,Lukáš Provod,MF,cz Czechia,27-260,1996,2.6,5,5,2,1,2,3,5,60.0,2,3,1,2,0,5,2,0,Matches
346,334,George Pușcaș,FW,ro Romania,28-092,1996,0.4,0,0,0,0,0,0,1,0.0,1,0,0,0,0,0,1,0,Matches
347,335,Leopold Querfeld,DF,at Austria,20-202,2003,0.3,2,2,1,1,0,2,2,100.0,0,0,0,0,1,3,1,0,Matches
348,336,Adrien Rabiot,MF,fr France,29-097,1995,3.4,6,3,2,4,0,3,4,75.0,1,3,0,3,1,7,2,0,Matches
349,337,Bogdan Racovitan,DF,ro Romania,24-033,2000,0.6,0,0,0,0,0,0,1,0.0,1,2,2,0,1,1,3,1,Matches
350,338,Predrag Rajković,GK,rs Serbia,28-252,1995,3.0,0,0,0,0,0,0,0,,0,0,0,0,0,0,0,0,Matches
351,339,Anthony Ralston,DF,sct Scotland,25-236,1998,2.9,3,2,3,0,0,1,3,33.3,2,5,1,4,1,4,7,1,Matches
352,340,Ylber Ramadani,MF,al Albania,28-088,1996,2.9,6,3,2,3,1,5,9,55.6,4,8,3,5,4,10,4,0,Matches
353,341,Gonçalo Ramos,FW,pt Portugal,23-019,2001,0.3,0,0,0,0,0,0,0,,0,1,0,1,0,0,1,0,Matches
354,342,Giacomo Raspadori,FW,it Italy,24-142,2000,0.9,3,1,1,2,0,1,2,50.0,1,0,0,0,0,3,0,0,Matches
355,343,Andrei Ratiu,DF,ro Romania,26-019,1998,4.0,6,5,4,2,0,4,5,80.0,1,6,2,4,6,12,15,0,Matches
356,344,David Raum,DF,de Germany,26-078,1998,1.8,5,5,3,1,1,5,7,71.4,2,1,0,1,0,5,1,0,Matches
357,345,David Raya,GK,es Spain,28-298,1995,1.0,0,0,0,0,0,0,0,,0,0,0,0,0,0,0,0,Matches
358,346,Tijjani Reijnders,MF,nl Netherlands,25-346,1998,4.5,7,6,1,6,0,3,5,60.0,2,4,0,4,3,10,4,0,Matches
359,347,Mateo Retegui,FW,it Italy,25-071,1999,1.7,2,1,0,1,1,0,1,0.0,1,1,0,1,0,2,0,0,Matches
360,348,Declan Rice,MF,eng England,25-177,1999,5.7,16,12,10,5,1,4,7,57.1,3,2,0,2,5,21,8,0,Matches
361,349,Fabian Rieder,MF,ch Switzerland,22-144,2002,2.4,7,3,1,4,2,3,5,60.0,2,2,1,1,0,7,1,0,Matches
362,350,Andrew Robertson,DF,sct Scotland,30-120,1994,3.0,8,5,4,4,0,8,10,80.0,2,2,0,2,1,9,10,1,Matches
364,351,Rodri,MF,es Spain,28-017,1996,4.3,12,7,4,7,1,4,7,57.1,3,3,2,1,0,12,7,0,Matches
365,352,Ricardo Rodríguez,DF,ch Switzerland,31-319,1992,5.3,7,6,2,3,2,3,4,75.0,1,5,2,3,3,10,19,0,Matches
366,353,Taras Romanchuk,MF,pl Poland,32-238,1991,0.6,2,1,2,0,0,1,2,50.0,1,1,0,1,0,2,1,0,Matches
367,354,Cristiano Ronaldo,FW,pt Portugal,39-155,1985,5.4,1,1,0,0,1,1,1,100.0,0,1,1,0,0,1,1,0,Matches
368,355,Antonio Rüdiger,DF,de Germany,31-128,1993,5.3,8,4,7,1,0,6,6,100.0,0,10,6,4,2,10,20,0,Matches
369,356,Fabián Ruiz Peña,MF,es Spain,28-097,1996,4.0,4,2,3,0,1,1,3,33.3,2,0,0,0,4,8,2,0,Matches
370,357,Adrian Rus,MF,ro Romania,28-113,1996,0.2,0,0,0,0,0,0,0,,0,0,0,0,0,0,0,0,Matches
371,358,Marcel Sabitzer,"FW,MF",at Austria,30-114,1994,4.0,2,1,0,1,1,2,2,100.0,0,2,0,2,3,5,1,0,Matches
372,359,Bukayo Saka,"FW,DF",eng England,22-308,2001,5.0,4,3,2,2,0,2,3,66.7,1,5,0,5,1,5,11,0,Matches
373,360,Bartosz Salamon,DF,pl Poland,33-069,1991,0.9,3,2,2,1,0,2,2,100.0,0,1,0,1,2,5,7,0,Matches
374,361,William Saliba,DF,fr France,23-107,2001,5.3,3,1,2,1,0,0,1,0.0,1,6,3,3,3,6,25,0,Matches
375,362,Roland Sallai,MF,hu Hungary,27-048,1997,3.0,4,2,1,1,2,1,2,50.0,1,0,0,0,1,5,1,0,Matches
376,363,Lazar Samardzic,MF,rs Serbia,22-136,2002,0.6,0,0,0,0,0,0,0,,0,0,0,0,0,0,0,0,Matches
377,364,Leroy Sané,FW,de Germany,28-180,1996,2.3,1,1,1,0,0,0,5,0.0,5,2,0,2,0,1,0,0,Matches
378,365,Leo Sauer,FW,sk Slovakia,18-206,2005,0.1,0,0,0,0,0,0,0,,0,0,0,0,0,0,0,0,Matches
379,366,Gianluca Scamacca,FW,it Italy,25-190,1999,2.8,1,1,0,0,1,0,0,,0,0,0,0,2,3,1,0,Matches
380,367,András Schäfer,MF,hu Hungary,25-087,1999,3.0,6,3,0,6,0,1,3,33.3,2,4,1,3,1,7,3,0,Matches
381,368,Fabian Schär,DF,ch Switzerland,32-202,1991,5.3,10,4,7,0,3,4,7,57.1,3,6,4,2,9,19,24,0,Matches
382,369,Patrik Schick,FW,cz Czechia,28-167,1996,1.4,1,1,1,0,0,0,3,0.0,3,1,0,1,1,2,4,0,Matches
383,370,Nico Schlotterbeck,DF,de Germany,24-221,1999,1.3,1,1,0,1,0,0,2,0.0,2,1,0,1,2,3,8,1,Matches
384,371,Kasper Schmeichel,GK,dk Denmark,37-247,1986,4.0,0,0,0,0,0,0,0,,0,0,0,0,0,0,0,0,Matches
385,372,Romano Schmid,"FW,MF",at Austria,24-164,2000,1.6,2,1,0,1,1,1,3,33.3,2,6,0,6,0,2,2,0,Matches
386,373,Jerdy Schouten,MF,nl Netherlands,27-179,1997,4.6,5,2,1,3,1,0,3,0.0,3,5,2,3,4,9,7,0,Matches
387,374,Ivan Schranz,FW,sk Slovakia,30-300,1993,3.7,3,1,3,0,0,1,3,33.3,2,0,0,0,2,5,9,0,Matches
388,375,Taulant Seferi,FW,al Albania,27-237,1996,1.0,2,2,0,2,0,2,5,40.0,3,0,0,0,2,4,2,0,Matches
390,376,Nicolas Seiwald,MF,at Austria,23-066,2001,4.0,15,7,5,8,2,4,11,36.4,7,5,1,4,6,21,8,0,Matches
391,377,Nélson Semedo,DF,pt Portugal,30-236,1993,1.1,3,2,2,1,0,2,6,33.3,4,1,0,1,0,3,0,0,Matches
392,378,Benjamin Šeško,FW,si Slovenia,21-039,2003,4.0,3,1,1,1,1,1,5,20.0,4,3,1,2,0,3,5,0,Matches
393,379,Petr Ševčík,MF,cz Czechia,30-066,1994,0.2,0,0,0,0,0,0,0,,0,0,0,0,0,0,0,0,Matches
394,380,Stephan El Shaarawy,FW,it Italy,31-256,1992,0.5,0,0,0,0,0,0,0,,0,0,0,0,0,0,2,0,Matches
395,381,Lawrence Shankland,FW,sct Scotland,28-334,1995,0.3,1,0,1,0,0,1,1,100.0,0,2,0,2,0,1,1,0,Matches
396,382,Mykola Shaparenko,MF,ua Ukraine,25-279,1998,2.4,3,0,2,1,0,3,4,75.0,1,4,0,4,3,6,1,0,Matches
397,383,Xherdan Shaqiri,"MF,FW",ch Switzerland,32-273,1991,0.8,0,0,0,0,0,0,0,,0,0,0,0,0,0,0,0,Matches
398,384,Luke Shaw,DF,eng England,28-363,1995,0.5,0,0,0,0,0,0,0,,0,0,0,0,0,0,2,0,Matches
399,385,Vincent Sierro,MF,ch Switzerland,28-275,1995,0.4,0,0,0,0,0,0,1,0.0,1,1,1,0,0,0,1,0,Matches
400,386,António Silva,DF,pt Portugal,20-253,2003,0.8,1,1,1,0,0,0,0,,0,0,0,0,0,1,2,1,Matches
401,387,Bernardo Silva,"FW,MF",pt Portugal,29-334,1994,4.7,5,4,1,3,1,1,6,16.7,5,2,0,2,0,5,3,0,Matches
402,388,Unai Simón,GK,es Spain,27-028,1997,4.3,0,0,0,0,0,0,0,,0,0,0,0,0,0,2,0,Matches
403,389,Xavi Simons,"MF,FW",nl Netherlands,21-079,2003,4.1,5,3,1,4,0,4,5,80.0,1,5,0,5,4,9,0,0,Matches
404,390,Michał Skóraś,DF,pl Poland,24-145,2000,0.3,1,1,0,1,0,0,0,,0,0,0,0,1,2,1,0,Matches
405,391,Łukasz Skorupski,GK,pl Poland,33-065,1991,1.0,0,0,0,0,0,0,0,,0,0,0,0,0,0,4,0,Matches
406,392,Andreas Skov Olsen,"MF,FW",dk Denmark,24-193,1999,1.4,1,1,0,0,1,1,2,50.0,1,2,0,2,0,1,2,0,Matches
407,393,Milan Škriniar,DF,sk Slovakia,29-149,1995,4.3,3,1,3,0,0,2,4,50.0,2,4,4,0,2,5,17,0,Matches
408,394,Bartosz Slisz,MF,pl Poland,25-102,1999,1.2,1,1,0,0,1,0,0,,0,1,0,1,2,3,3,0,Matches
409,395,Yann Sommer,GK,ch Switzerland,35-205,1988,5.3,0,0,0,0,0,0,0,,0,0,0,0,0,0,2,0,Matches
410,396,Deian Sorescu,"MF,DF",ro Romania,26-315,1997,0.4,0,0,0,0,0,0,0,,0,1,0,1,1,1,1,0,Matches
411,397,Borna Sosa,DF,hr Croatia,26-170,1998,0.1,0,0,0,0,0,0,1,0.0,1,1,1,0,0,0,0,0,Matches
412,398,Tomáš Souček,MF,cz Czechia,29-133,1995,3.0,5,3,2,2,1,3,6,50.0,3,6,2,4,3,8,5,0,Matches
413,399,Andraž Šporar,FW,si Slovenia,30-133,1994,3.8,2,2,1,0,1,1,1,100.0,0,2,1,1,0,2,4,0,Matches
414,400,Nicolae Stanciu,"MF,FW",ro Romania,31-063,1993,3.9,3,2,1,2,0,1,4,25.0,3,1,1,0,1,4,5,0,Matches
416,401,Jindřich Staněk,GK,cz Czechia,28-073,1996,2.6,0,0,0,0,0,0,0,,0,0,0,0,0,0,1,0,Matches
417,402,Josip Stanišić,DF,hr Croatia,24-098,2000,2.0,10,8,3,5,2,5,9,55.6,4,3,1,2,4,14,2,0,Matches
418,403,Renato Steffen,DF,ch Switzerland,32-249,1991,0.0,0,0,0,0,0,0,0,,0,0,0,0,0,0,0,0,Matches
419,404,Taras Stepanenko,MF,ua Ukraine,34-336,1989,0.9,3,3,3,0,0,3,5,60.0,2,2,1,1,1,4,2,0,Matches
420,405,Leonidas Stergiou,DF,ch Switzerland,22-128,2002,0.5,4,2,3,1,0,1,3,33.3,2,0,0,0,0,4,4,0,Matches
421,406,Petar Stojanović,MF,si Slovenia,28-276,1995,3.5,6,5,5,1,0,3,8,37.5,5,4,1,3,1,7,4,0,Matches
422,407,John Stones,DF,eng England,30-042,1994,5.7,3,3,2,0,1,1,1,100.0,0,2,2,0,1,4,13,0,Matches
423,408,Thomas Strakosha,GK,al Albania,29-112,1995,3.0,0,0,0,0,0,0,0,,0,0,0,0,0,0,1,0,Matches
424,409,Dávid Strelec,FW,sk Slovakia,23-096,2001,2.0,0,0,0,0,0,0,0,,0,2,0,2,0,0,0,0,Matches
425,410,Callum Styles,MF,hu Hungary,24-103,2000,0.7,0,0,0,0,0,0,1,0.0,1,0,0,0,1,1,1,0,Matches
426,411,Luka Sučić,"FW,MF",hr Croatia,21-305,2002,1.6,0,0,0,0,0,0,0,,0,4,0,4,1,1,1,0,Matches
427,412,Heorhiy Sudakov,MF,ua Ukraine,21-312,2002,2.9,3,1,2,1,0,3,4,75.0,1,4,1,3,0,3,1,0,Matches
428,413,Pavel Šulc,MF,cz Czechia,23-193,2000,0.9,1,1,1,0,0,1,2,50.0,1,1,1,0,1,2,2,0,Matches
429,414,Tomáš Suslov,"FW,MF",sk Slovakia,22-032,2002,1.4,4,1,1,3,0,1,4,25.0,3,4,0,4,1,5,0,0,Matches
430,415,Josip Šutalo,DF,hr Croatia,24-132,2000,3.0,5,3,5,0,0,2,3,66.7,1,6,5,1,13,18,7,1,Matches
431,416,Oleksandr Svatok,DF,ua Ukraine,29-286,1994,0.9,0,0,0,0,0,0,0,,0,2,1,1,3,3,2,0,Matches
432,417,Karol Świderski,FW,pl Poland,27-168,1997,1.0,0,0,0,0,0,0,0,,0,0,0,0,0,0,0,0,Matches
433,418,Serhiy Sydorchuk,MF,ua Ukraine,33-068,1991,0.1,0,0,0,0,0,0,0,,0,0,0,0,0,0,0,0,Matches
434,419,Attila Szalai,DF,hu Hungary,26-171,1998,1.1,2,2,2,0,0,1,3,33.3,2,0,0,0,2,4,2,0,Matches
435,420,Wojciech Szczęsny,GK,pl Poland,34-082,1990,2.0,0,0,0,0,0,0,1,0.0,1,1,0,1,0,0,2,0,Matches
436,421,Dominik Szoboszlai,MF,hu Hungary,23-258,2000,3.0,2,0,0,1,1,0,0,,0,4,1,3,2,4,6,0,Matches
437,422,Sebastian Szymański,MF,pl Poland,25-060,1999,1.2,7,2,5,2,0,5,10,50.0,5,3,1,2,3,10,1,0,Matches
438,423,Dušan Tadić,MF,rs Serbia,35-232,1988,1.7,2,2,0,1,1,0,0,,0,1,0,1,1,3,3,0,Matches
439,424,Jonathan Tah,DF,de Germany,28-149,1996,3.5,2,1,1,1,0,1,1,100.0,0,2,1,1,4,6,11,0,Matches
440,425,Maksym Talovierov,MF,ua Ukraine,24-011,2000,0.0,0,0,0,0,0,0,0,,0,0,0,0,0,0,0,0,Matches
442,426,Aurélien Tchouaméni,MF,fr France,24-164,2000,4.2,6,5,2,3,1,2,5,40.0,3,0,0,0,4,10,9,1,Matches
443,427,Arthur Theate,DF,be Belgium,24-045,2000,2.8,2,2,0,0,2,0,1,0.0,1,5,0,5,2,4,9,0,Matches
444,428,Marcus Thuram,FW,fr France,26-338,1997,2.9,2,2,0,0,2,0,0,,0,6,2,4,0,2,2,0,Matches
445,429,Youri Tielemans,MF,be Belgium,27-063,1997,1.6,2,2,1,1,0,0,1,0.0,1,3,1,2,1,3,0,0,Matches
446,430,Kieran Tierney,DF,sct Scotland,27-034,1997,1.5,2,1,2,0,0,1,3,33.3,2,1,1,0,0,2,4,0,Matches
447,431,Ivan Toney,FW,eng England,28-115,1996,0.5,1,1,0,1,0,0,0,,0,0,0,0,0,1,1,0,Matches
448,432,Ferrán Torres,"FW,MF",es Spain,24-131,2000,1.7,0,0,0,0,0,0,1,0.0,1,3,0,3,1,1,1,0,Matches
449,433,Cenk Tosun,FW,tr Türkiye,33-032,1991,0.3,0,0,0,0,0,0,0,,0,0,0,0,0,0,0,0,Matches
450,434,Gernot Trauner,DF,at Austria,32-106,1992,1.0,2,1,2,0,0,0,1,0.0,1,2,2,0,1,3,1,0,Matches
451,435,Kieran Trippier,DF,eng England,33-294,1990,4.5,5,4,2,2,1,2,7,28.6,5,3,1,2,5,10,7,0,Matches
452,436,Leandro Trossard,FW,be Belgium,29-218,1994,1.9,2,1,1,1,0,1,2,50.0,1,2,0,2,0,2,0,0,Matches
453,437,Anatolii Trubin,GK,ua Ukraine,22-343,2001,2.0,0,0,0,0,0,0,0,,0,0,0,0,0,0,1,0,Matches
454,438,Heorhii Tsitaishvili,"DF,MF",ge Georgia,23-234,2000,2.1,5,4,5,0,0,3,3,100.0,0,0,0,0,0,5,3,1,Matches
455,439,Viktor Tsyhankov,FW,ua Ukraine,26-237,1997,0.7,0,0,0,0,0,0,1,0.0,1,1,0,1,0,0,1,0,Matches
456,440,Ľubomír Tupta,MF,sk Slovakia,26-104,1998,0.1,0,0,0,0,0,0,0,,0,0,0,0,0,0,0,0,Matches
457,441,Oleksandr Tymchyk,DF,ua Ukraine,27-171,1997,2.2,10,4,5,5,0,6,12,50.0,6,2,0,2,3,13,6,0,Matches
458,442,Deniz Undav,MF,de Germany,27-356,1996,0.1,1,1,0,0,1,1,1,100.0,0,0,0,0,0,1,0,0,Matches
459,443,Dayot Upamecano,DF,fr France,25-256,1998,5.3,8,6,5,3,0,5,6,83.3,1,3,1,2,6,14,18,0,Matches
460,444,Kacper Urbanski,"FW,MF",pl Poland,19-306,2004,1.6,2,1,2,0,0,1,3,33.3,2,2,0,2,1,3,2,0,Matches
461,445,Virgil van Dijk,DF,nl Netherlands,33-001,1991,5.0,2,2,2,0,0,1,1,100.0,0,5,4,1,2,4,30,1,Matches
462,446,Vladyslav Vanat,FW,ua Ukraine,22-187,2002,0.2,0,0,0,0,0,0,0,,0,0,0,0,0,0,0,0,Matches
463,447,Barnabás Varga,FW,hu Hungary,30-166,1994,2.8,4,1,1,2,1,2,2,100.0,0,5,1,4,1,5,7,0,Matches
464,448,Ruben Vargas,"MF,FW",ch Switzerland,25-339,1998,3.4,6,5,3,2,1,2,4,50.0,2,5,0,5,2,8,4,1,Matches
465,449,Denis Vavro,DF,sk Slovakia,28-090,1996,4.3,2,1,2,0,0,2,4,50.0,2,6,5,1,2,4,18,0,Matches
466,450,Joey Veerman,MF,nl Netherlands,25-233,1998,1.7,2,1,0,1,1,2,5,40.0,3,3,1,2,0,2,1,0,Matches
468,451,Miloš Veljković,DF,rs Serbia,28-287,1995,3.0,2,0,2,0,0,2,2,100.0,0,0,0,0,0,2,6,0,Matches
469,452,Micky van de Ven,DF,nl Netherlands,23-081,2001,0.8,1,1,1,0,0,1,2,50.0,1,2,1,1,0,1,5,0,Matches
470,453,Benjamin Verbič,MF,si Slovenia,30-225,1993,0.8,3,2,1,2,0,1,3,33.3,2,0,0,0,1,4,2,0,Matches
471,454,Bart Verbruggen,GK,nl Netherlands,21-326,2002,5.0,1,1,1,0,0,0,0,,0,0,0,0,0,1,3,0,Matches
472,455,Jan Vertonghen,DF,be Belgium,37-076,1987,3.0,4,2,1,3,0,0,0,,0,2,1,1,0,4,10,0,Matches
473,456,Jannik Vestergaard,DF,dk Denmark,31-341,1992,4.0,3,3,3,0,0,3,3,100.0,0,3,2,1,4,7,12,0,Matches
474,457,Žan Vipotnik,FW,si Slovenia,22-113,2002,0.2,0,0,0,0,0,0,1,0.0,1,0,0,0,0,0,1,0,Matches
475,458,Vitinha,MF,pt Portugal,24-147,2000,4.0,3,3,0,2,1,1,3,33.3,2,3,1,2,2,5,3,0,Matches
476,459,Daniel Vivian,DF,es Spain,24-360,1999,1.0,2,2,2,0,0,2,2,100.0,0,1,1,0,1,3,6,0,Matches
477,460,Dušan Vlahović,"MF,FW",rs Serbia,24-163,2000,2.0,0,0,0,0,0,0,1,0.0,1,0,0,0,1,1,0,0,Matches
478,461,Stefan de Vrij,DF,nl Netherlands,32-155,1992,5.0,11,6,7,3,1,7,8,87.5,1,5,2,3,1,12,15,0,Matches
479,462,Kyle Walker,DF,eng England,34-042,1990,5.7,4,1,2,2,0,2,4,50.0,2,4,1,3,4,8,5,0,Matches
480,463,Ollie Watkins,FW,eng England,28-192,1995,0.2,0,0,0,0,0,0,0,,0,0,0,0,1,1,0,0,Matches
481,464,Wout Weghorst,FW,nl Netherlands,31-337,1992,1.0,2,1,1,1,0,1,1,100.0,0,2,1,1,0,2,2,0,Matches
482,465,Andreas Weimann,FW,at Austria,32-339,1991,0.0,0,0,0,0,0,0,0,,0,0,0,0,0,0,0,0,Matches
483,466,Silvan Widmer,DF,ch Switzerland,31-126,1993,3.3,2,1,1,1,0,1,1,100.0,0,3,1,2,2,4,11,0,Matches
484,467,Georginio Wijnaldum,MF,nl Netherlands,33-241,1990,0.8,0,0,0,0,0,0,0,,0,0,0,0,0,0,0,0,Matches
485,468,Nico Williams,FW,es Spain,21-363,2002,3.5,2,1,0,1,1,1,3,33.3,2,3,0,3,0,2,0,0,Matches
486,469,Patrick Wimmer,"FW,MF",at Austria,23-040,2001,1.5,2,2,0,2,0,1,5,20.0,4,4,0,4,0,2,1,0,Matches
487,470,Jonas Wind,FW,dk Denmark,25-153,1999,2.1,0,0,0,0,0,0,1,0.0,1,1,0,1,0,0,1,0,Matches
488,471,Florian Wirtz,"FW,MF",de Germany,21-067,2003,3.1,3,3,0,2,1,1,3,33.3,2,3,0,3,1,4,1,0,Matches
489,472,Maximilian Wöber,DF,at Austria,26-156,1998,1.9,4,3,2,2,0,2,3,66.7,1,3,2,1,4,8,6,0,Matches
490,473,Granit Xhaka,MF,ch Switzerland,31-286,1992,5.3,8,5,3,4,1,4,6,66.7,2,5,4,1,1,9,15,0,Matches
491,474,Lamine Yamal,FW,es Spain,16-362,2007,3.6,7,5,4,2,1,3,7,42.9,4,5,0,5,3,10,0,0,Matches
492,475,Roman Yaremchuk,FW,ua Ukraine,28-225,1995,1.3,0,0,0,0,0,0,2,0.0,2,1,1,0,0,0,1,0,Matches
494,476,Andriy Yarmolenko,"FW,MF",ua Ukraine,34-260,1989,1.2,2,2,0,1,1,1,3,33.3,2,1,0,1,1,3,0,0,Matches
495,477,Yusuf Yazıcı,"MF,FW",tr Türkiye,27-162,1997,0.6,1,1,0,0,1,1,3,33.3,2,0,0,0,0,1,0,0,Matches
496,478,Kenan Yıldız,"FW,MF",tr Türkiye,19-066,2005,3.8,3,2,2,1,0,2,2,100.0,0,4,0,4,0,3,2,0,Matches
497,479,Okay Yokuşlu,"MF,DF",tr Türkiye,30-122,1994,0.6,2,1,1,1,0,0,1,0.0,1,2,0,2,2,4,4,0,Matches
498,480,İsmail Yüksek,MF,tr Türkiye,25-165,1999,1.7,6,2,2,3,1,3,5,60.0,2,2,1,1,1,7,4,0,Matches
499,481,Illia Zabarnyi,DF,ua Ukraine,21-312,2002,3.0,4,3,4,0,0,1,2,50.0,1,2,2,0,1,5,7,0,Matches
500,482,Mattia Zaccagni,"MF,FW",it Italy,29-023,1995,0.9,1,0,0,1,0,0,1,0.0,1,1,0,1,1,2,0,0,Matches
501,483,Denis Zakaria,MF,ch Switzerland,27-232,1996,0.3,0,0,0,0,0,0,0,,0,1,0,1,0,0,1,0,Matches
502,484,Nicola Zalewski,DF,pl Poland,22-168,2002,2.7,3,1,2,1,0,1,5,20.0,4,2,1,1,2,5,4,0,Matches
503,485,Piotr Zieliński,MF,pl Poland,30-050,1994,2.8,0,0,0,0,0,0,2,0.0,2,4,0,4,2,2,3,0,Matches
504,486,Oleksandr Zinchenko,DF,ua Ukraine,27-207,1996,2.4,6,5,4,1,1,4,8,50.0,4,4,1,3,1,7,4,0,Matches
505,487,Joshua Zirkzee,FW,nl Netherlands,23-048,2001,0.0,1,1,1,0,0,0,0,,0,0,0,0,0,1,0,0,Matches
506,488,Andrija Živković,DF,rs Serbia,27-364,1996,2.7,2,2,2,0,0,1,2,50.0,1,3,0,3,0,2,5,0,Matches
507,489,Budu Zivzivadze,"FW,MF",ge Georgia,30-121,1994,0.2,0,0,0,0,0,0,0,,0,0,0,0,0,0,0,0,Matches
508,490,Steven Zuber,MF,ch Switzerland,32-327,1991,0.9,0,0,0,0,0,0,1,0.0,1,0,0,0,0,0,0,0,Matches
509,491,Martín Zubimendi,MF,es Spain,25-158,1999,1.1,4,2,2,1,1,2,4,50.0,2,1,1,0,0,4,0,0,Matches
510,492,Oleksandr Zubkov,FW,ua Ukraine,27-341,1996,0.3,1,0,1,0,0,0,3,0.0,3,1,0,1,0,1,1,0,Matches
