,Rk,Player,Pos,Squad,Age,Born,90s,Tkl,TklW,Def 3rd,Mid 3rd,Att 3rd,Tkl.1,Att,Tkl%,Lost,Blocks,Sh,Pass,Int,Tkl+Int,Clr,Err,Matches
0,1,Che Adams,FW,sct Scotland,28-000,1996,2.3,2,1,1,1,0,1,1,100.0,0,2,0,2,1,3,0,0,Matches
1,2,Michel Aebischer,DF,ch Switzerland,27-189,1997,5.3,4,3,2,2,0,1,11,9.1,10,3,1,2,2,6,7,0,Matches
2,3,Arlind Ajeti,DF,al Albania,30-292,1993,3.0,1,0,0,1,0,1,3,33.3,2,5,4,1,6,7,13,0,Matches
3,4,Manuel Akanji,DF,ch Switzerland,28-360,1995,5.3,2,2,2,0,0,1,2,50.0,1,6,6,0,4,6,22,0,Matches
4,5,Samet Akaydın,DF,tr Türkiye,30-122,1994,3.7,8,4,8,0,0,6,8,75.0,2,5,5,0,7,15,16,0,Matches
5,6,Nathan Aké,DF,nl Netherlands,29-146,1995,5.2,7,5,7,0,0,4,7,57.1,3,4,3,1,6,13,14,0,Matches
6,7,Yunus Akgün,FW,tr Türkiye,24-006,2000,0.8,2,1,1,1,0,2,2,100.0,0,1,0,1,0,2,0,0,Matches
7,8,Kerem Aktürkoğlu,"FW,MF",tr Türkiye,25-266,1998,1.2,1,1,1,0,0,1,2,50.0,1,1,0,1,1,2,3,0,Matches
8,9,Trent Alexander-Arnold,"MF,DF",eng England,25-280,1998,1.5,1,0,1,0,0,0,1,0.0,1,4,2,2,2,3,3,1,Matches
9,10,Denis Alibec,FW,ro Romania,33-190,1991,0.3,0,0,0,0,0,0,0,,0,0,0,0,0,0,0,0,Matches
10,11,Barış Alper Yılmaz,FW,tr Türkiye,24-051,2000,5.0,5,0,0,3,2,1,3,33.3,2,1,0,1,0,5,1,0,Matches
11,12,Sandro Altunashvili,MF,ge Georgia,27-055,1997,0.6,0,0,0,0,0,0,0,,0,0,0,0,0,0,3,1,Matches
12,13,Zeki Amdouni,"MF,FW",ch Switzerland,23-222,2000,0.6,0,0,0,0,0,0,2,0.0,2,0,0,0,0,0,1,0,Matches
13,14,Joachim Andersen,DF,dk Denmark,28-043,1996,4.0,5,1,2,3,0,3,3,100.0,0,4,1,3,2,7,11,0,Matches
14,15,Robert Andrich,MF,de Germany,29-295,1994,3.5,12,8,8,4,0,5,7,71.4,2,3,1,2,2,14,12,0,Matches
15,16,Waldemar Anton,DF,de Germany,27-359,1996,0.4,0,0,0,0,0,0,0,,0,0,0,0,0,0,2,0,Matches
16,17,Stuart Armstrong,MF,sct Scotland,32-105,1992,0.2,1,0,1,0,0,0,0,,0,0,0,0,0,1,0,0,Matches
17,18,Marko Arnautović,FW,at Austria,35-085,1989,3.1,2,1,0,1,1,1,1,100.0,0,1,0,1,0,2,2,0,Matches
18,19,Jasir Asani,FW,al Albania,29-055,1995,2.3,3,1,3,0,0,1,7,14.3,6,1,0,1,4,7,4,0,Matches
19,20,Kristjan Asllani,MF,al Albania,22-126,2002,3.0,1,1,1,0,0,0,2,0.0,2,0,0,0,3,4,6,0,Matches
20,21,Kaan Ayhan,"MF,DF",tr Türkiye,29-246,1994,4.0,6,3,3,2,1,4,10,40.0,6,5,0,5,2,8,17,0,Matches
21,22,Alex Baena,"MF,FW",es Spain,22-359,2001,0.3,1,1,1,0,0,1,3,33.3,2,0,0,0,0,1,0,0,Matches
22,23,Alexander Bah,"DF,MF",dk Denmark,26-217,1997,3.1,4,4,2,1,1,4,8,50.0,4,1,0,1,5,9,5,0,Matches
23,24,Nedim Bajrami,"FW,MF",al Albania,25-136,1999,2.7,3,1,2,1,0,0,2,0.0,2,1,0,1,0,3,1,0,Matches
24,25,Johan Bakayoko,"FW,DF",be Belgium,21-084,2003,0.5,2,1,1,1,0,0,3,0.0,3,0,0,0,0,2,0,0,Matches
26,26,Jure Balkovec,DF,si Slovenia,29-308,1994,1.3,6,3,2,3,1,2,5,40.0,3,2,0,2,2,8,8,0,Matches
27,27,Iván Balliu,DF,al Albania,32-194,1992,1.0,0,0,0,0,0,0,0,,0,1,1,0,2,2,2,0,Matches
28,28,Nicușor Bancu,DF,ro Romania,31-299,1992,3.0,2,2,2,0,0,1,1,100.0,0,6,2,4,0,2,11,0,Matches
29,29,Antonín Barák,MF,cz Czechia,29-223,1994,0.5,1,1,0,0,1,0,1,0.0,1,0,0,0,0,1,0,0,Matches
30,30,Bradley Barcola,"FW,MF",fr France,21-315,2002,1.1,4,4,1,1,2,1,4,25.0,3,6,0,6,0,4,0,0,Matches
31,31,Abdülkerim Bardakcı,DF,tr Türkiye,29-310,1994,4.0,4,2,4,0,0,3,6,50.0,3,5,3,2,2,6,20,0,Matches
32,32,Nicolò Barella,MF,it Italy,27-157,1997,3.7,10,5,3,7,0,5,8,62.5,3,3,0,3,3,13,2,1,Matches
33,33,Alessandro Bastoni,DF,it Italy,25-091,1999,4.0,5,2,2,3,0,2,3,66.7,1,4,2,2,1,6,17,0,Matches
34,34,Martin Baturina,FW,hr Croatia,21-148,2003,0.1,1,1,0,1,0,0,0,,0,0,0,0,0,1,0,0,Matches
35,35,Christoph Baumgartner,"MF,FW",at Austria,24-347,1999,3.2,4,1,2,1,1,1,2,50.0,1,1,0,1,1,5,3,0,Matches
36,36,Altay Bayındır,GK,tr Türkiye,26-090,1998,1.0,0,0,0,0,0,0,0,,0,0,0,0,0,0,0,0,Matches
37,37,Jan Bednarek,DF,pl Poland,28-092,1996,3.0,2,1,2,0,0,2,6,33.3,4,8,7,1,3,5,13,0,Matches
38,38,Maximilian Beier,FW,de Germany,21-270,2002,0.3,0,0,0,0,0,0,0,,0,0,0,0,0,0,0,0,Matches
39,39,Jude Bellingham,MF,eng England,21-014,2003,6.4,9,6,1,4,4,1,5,20.0,4,5,1,4,3,12,4,1,Matches
40,40,László Bénes,MF,sk Slovakia,26-308,1997,0.8,1,1,0,0,1,1,1,100.0,0,0,0,0,0,1,1,0,Matches
41,41,Bartosz Bereszyński,DF,pl Poland,32-001,1992,0.1,0,0,0,0,0,0,0,,0,0,0,0,0,0,0,0,Matches
42,42,Steven Bergwijn,FW,nl Netherlands,26-279,1997,1.0,0,0,0,0,0,0,1,0.0,1,1,0,1,0,0,1,0,Matches
43,43,Medon Berisha,MF,al Albania,20-266,2003,0.2,0,0,0,0,0,0,0,,0,0,0,0,1,1,0,0,Matches
44,44,Victor Bernth Kristiansen,"DF,MF",dk Denmark,21-210,2002,1.7,4,3,3,1,0,1,2,50.0,1,2,0,2,0,4,4,1,Matches
45,45,Matúš Bero,"MF,DF",sk Slovakia,28-311,1995,0.5,1,1,0,1,0,0,0,,0,0,0,0,1,2,0,0,Matches
46,46,Jaka Bijol,DF,si Slovenia,25-159,1999,4.3,11,6,10,1,0,5,6,83.3,1,10,7,3,6,17,38,0,Matches
47,47,Veljko Birmančević,DF,rs Serbia,26-130,1998,0.3,0,0,0,0,0,0,0,,0,0,0,0,2,2,0,0,Matches
48,48,Daley Blind,FW,nl Netherlands,34-126,1990,0.0,0,0,0,0,0,0,0,,0,0,0,0,0,0,0,0,Matches
49,49,Bendegúz Bolla,DF,hu Hungary,24-234,1999,2.3,4,3,3,0,1,2,4,50.0,2,3,1,2,1,5,9,0,Matches
50,50,Endre Botka,DF,hu Hungary,29-323,1994,1.0,3,1,2,1,0,1,1,100.0,0,0,0,0,1,4,3,0,Matches
52,51,Jarrod Bowen,FW,eng England,27-206,1996,0.4,1,1,0,1,0,0,1,0.0,1,1,0,1,1,2,1,0,Matches
53,52,Róbert Boženík,FW,sk Slovakia,24-238,1999,2.3,3,3,0,3,0,0,1,0.0,1,1,0,1,0,3,3,0,Matches
54,53,Volodymyr Brazhko,MF,ua Ukraine,22-172,2002,2.0,8,5,5,3,0,1,1,100.0,0,2,1,1,5,13,4,0,Matches
55,54,David Brekalo,MF,si Slovenia,25-223,1998,0.0,0,0,0,0,0,0,0,,0,0,0,0,0,0,2,0,Matches
56,55,Brian Brobbey,FW,nl Netherlands,22-163,2002,0.0,0,0,0,0,0,0,0,,0,0,0,0,0,0,0,0,Matches
57,56,Armando Broja,FW,al Albania,22-307,2001,1.2,1,1,0,0,1,0,0,,0,0,0,0,0,1,1,0,Matches
58,57,Marcelo Brozović,MF,hr Croatia,31-240,1992,2.5,1,0,1,0,0,0,2,0.0,2,3,1,2,4,5,4,0,Matches
59,58,Jacob Bruun Larsen,FW,dk Denmark,25-298,1998,0.1,0,0,0,0,0,0,0,,0,0,0,0,0,0,0,0,Matches
60,59,Ante Budimir,FW,hr Croatia,32-357,1991,1.4,2,2,0,1,1,1,1,100.0,0,3,1,2,0,2,2,0,Matches
61,60,Adam Buksa,FW,pl Poland,28-001,1996,1.7,0,0,0,0,0,0,0,,0,4,0,4,0,0,3,0,Matches
62,61,Andrei Burcă,DF,ro Romania,31-089,1993,4.0,4,2,3,1,0,3,4,75.0,1,7,4,3,1,5,23,0,Matches
63,62,Riccardo Calafiori,DF,it Italy,22-055,2002,3.0,3,1,3,0,0,2,6,33.3,4,2,1,1,6,9,9,0,Matches
64,63,Hakan Çalhanoğlu,MF,tr Türkiye,30-156,1994,3.9,5,4,3,2,0,3,6,50.0,3,3,1,2,1,6,6,0,Matches
65,64,Eduardo Camavinga,MF,fr France,21-246,2002,1.9,5,2,3,1,1,2,5,40.0,3,9,1,8,1,6,5,0,Matches
66,65,Andrea Cambiaso,"FW,DF",it Italy,24-144,2000,0.8,4,4,4,0,0,3,4,75.0,1,1,1,0,0,4,0,0,Matches
67,66,Emre Can,MF,de Germany,30-183,1994,1.1,4,3,2,2,0,2,2,100.0,0,2,2,0,1,5,2,0,Matches
68,67,João Cancelo,"DF,MF",pt Portugal,30-047,1994,3.8,6,4,2,2,2,4,8,50.0,4,2,0,2,4,10,8,1,Matches
69,68,Yannick Carrasco,"DF,FW",be Belgium,30-313,1993,2.4,4,2,0,4,0,3,7,42.9,4,0,0,0,0,4,3,0,Matches
70,69,Dani Carvajal,DF,es Spain,32-184,1992,4.2,5,2,3,0,2,2,6,33.3,4,5,2,3,6,11,5,0,Matches
71,70,Timothy Castagne,DF,be Belgium,28-221,1995,4.0,1,1,0,1,0,0,2,0.0,2,5,2,3,2,3,14,0,Matches
72,71,Koen Casteels,GK,be Belgium,32-018,1992,4.0,0,0,0,0,0,0,0,,0,0,0,0,0,0,2,0,Matches
73,72,Žan Celar,"FW,MF",si Slovenia,25-121,1999,0.7,1,1,0,1,0,1,1,100.0,0,0,0,0,1,2,2,0,Matches
74,73,Zeki Çelik,"DF,MF",tr Türkiye,27-147,1997,1.2,3,0,2,1,0,3,4,75.0,1,1,0,1,0,3,0,0,Matches
75,74,Václav Černý,MF,cz Czechia,26-270,1997,0.6,1,1,1,0,0,1,3,33.3,2,1,0,1,0,1,1,0,Matches
76,75,Giorgi Chakvetadze,"MF,FW",ge Georgia,24-319,1999,2.7,10,5,7,2,1,6,9,66.7,3,7,2,5,1,11,3,0,Matches
78,76,Federico Chiesa,"FW,MF",it Italy,26-262,1997,2.9,6,4,4,1,1,3,5,60.0,2,0,0,0,3,9,2,0,Matches
79,77,Tomáš Chorý,MF,cz Czechia,29-169,1995,0.4,0,0,0,0,0,0,0,,0,0,0,0,0,0,0,0,Matches
80,78,Andreas Christensen,DF,dk Denmark,28-094,1996,3.9,4,2,4,0,0,3,3,100.0,0,3,1,2,6,10,11,0,Matches
81,79,Ryan Christie,"MF,FW",sct Scotland,29-142,1995,1.1,0,0,0,0,0,0,0,,0,0,0,0,0,0,1,0,Matches
82,80,Mojmir Chytil,FW,cz Czechia,25-075,1999,1.2,0,0,0,0,0,0,0,,0,2,0,2,0,0,2,0,Matches
83,81,Alexandru Cicâldău,MF,ro Romania,27-005,1997,0.2,2,0,2,0,0,1,1,100.0,0,1,0,1,0,2,0,0,Matches
84,82,Florinel Coman,MF,ro Romania,26-094,1998,1.3,1,1,1,0,0,0,0,,0,1,0,1,1,2,2,0,Matches
85,83,Kingsley Coman,MF,fr France,28-030,1996,0.2,0,0,0,0,0,0,0,,0,0,0,0,0,0,0,0,Matches
86,84,Francisco Conceição,"FW,MF",pt Portugal,21-212,2002,2.0,2,1,0,2,0,0,3,0.0,3,1,0,1,0,2,0,0,Matches
87,85,Diogo Costa,GK,pt Portugal,24-298,1999,5.7,0,0,0,0,0,0,0,,0,0,0,0,0,0,2,0,Matches
88,86,Vladimír Coufal,"DF,FW",cz Czechia,31-326,1992,3.0,5,4,4,1,0,4,9,44.4,5,7,6,1,2,7,13,0,Matches
89,87,Bryan Cristante,MF,it Italy,29-132,1995,1.5,0,0,0,0,0,0,0,,0,1,1,0,2,2,1,0,Matches
90,88,Kevin Csoboth,DF,hu Hungary,24-023,2000,0.1,0,0,0,0,0,0,1,0.0,1,1,0,1,0,0,0,0,Matches
91,89,Marc Cucurella,DF,es Spain,25-357,1998,5.1,12,9,3,6,3,5,8,62.5,3,9,4,5,6,18,10,0,Matches
92,90,Mirlind Daku,FW,al Albania,26-194,1998,0.1,1,0,0,0,1,0,0,,0,0,0,0,0,1,0,0,Matches
93,91,Diogo Dalot,"DF,MF",pt Portugal,25-117,1999,1.7,1,1,1,0,0,0,0,,0,2,1,1,1,2,1,0,Matches
94,92,Mikkel Damsgaard,FW,dk Denmark,24-010,2000,0.4,1,1,1,0,0,0,0,,0,1,0,1,1,2,1,0,Matches
95,93,Kevin Danso,DF,at Austria,25-298,1998,2.4,0,0,0,0,0,0,1,0.0,1,4,3,1,0,0,13,0,Matches
96,94,Márton Dárdai,DF,hu Hungary,22-152,2002,1.9,4,1,4,0,0,2,5,40.0,3,2,0,2,0,4,3,0,Matches
97,95,Matteo Darmian,DF,it Italy,34-224,1989,1.8,1,1,1,0,0,1,2,50.0,1,4,3,1,1,2,6,0,Matches
98,96,Zuriko Davitashvili,"FW,MF",ge Georgia,23-149,2001,1.3,4,3,2,0,2,2,3,66.7,1,3,0,3,0,4,1,0,Matches
99,97,Paweł Dawidowicz,DF,pl Poland,29-054,1995,2.0,1,0,1,0,0,0,1,0.0,1,4,3,1,0,1,7,0,Matches
100,98,Kevin De Bruyne,MF,be Belgium,33-015,1991,4.0,5,1,3,0,2,1,3,33.3,2,2,0,2,0,5,2,0,Matches
101,99,Charles De Ketelaere,FW,be Belgium,23-125,2001,0.0,0,0,0,0,0,0,0,,0,0,0,0,0,0,0,0,Matches
102,100,Zeno Debast,DF,be Belgium,20-263,2003,1.2,3,1,2,1,0,1,1,100.0,0,3,1,2,0,3,8,0,Matches
104,101,Thomas Delaney,MF,dk Denmark,32-314,1991,0.9,0,0,0,0,0,0,0,,0,0,0,0,2,2,2,0,Matches
105,102,Ousmane Dembélé,"FW,MF",fr France,27-059,1997,4.0,8,5,0,5,3,3,3,100.0,0,7,0,7,1,9,2,1,Matches
106,103,Merih Demiral,DF,tr Türkiye,26-130,1998,2.3,2,2,2,0,0,2,2,100.0,0,8,6,2,4,6,26,1,Matches
107,104,Giovanni Di Lorenzo,"DF,FW",it Italy,30-344,1993,4.0,13,9,9,3,1,7,12,58.3,5,4,1,3,6,19,6,1,Matches
108,105,Rúben Dias,DF,pt Portugal,27-060,1997,4.7,2,1,2,0,0,1,3,33.3,2,7,4,3,3,5,12,0,Matches
109,106,Federico Dimarco,"DF,FW",it Italy,26-246,1997,2.5,4,2,0,2,2,2,2,100.0,0,4,2,2,2,6,2,1,Matches
110,107,Berat Djimsiti,DF,al Albania,31-145,1993,3.0,1,0,1,0,0,0,1,0.0,1,8,5,3,2,3,16,0,Matches
111,108,Jeremy Doku,"FW,MF",be Belgium,22-047,2002,3.6,3,2,3,0,0,1,4,25.0,3,1,0,1,1,4,1,1,Matches
112,109,Kasper Dolberg,FW,dk Denmark,26-281,1997,0.4,1,1,0,1,0,0,0,,0,0,0,0,0,1,0,0,Matches
113,110,Gianluigi Donnarumma,GK,it Italy,25-139,1999,4.0,0,0,0,0,0,0,0,,0,0,0,0,0,0,2,0,Matches
114,111,David Doudera,FW,cz Czechia,26-043,1998,1.0,3,2,3,0,0,3,4,75.0,1,1,0,1,0,3,2,0,Matches
115,112,Artem Dovbyk,FW,ua Ukraine,27-022,1997,2.7,2,2,0,0,2,0,0,,0,0,0,0,1,3,2,0,Matches
116,113,Denis Drăguș,FW,ro Romania,25-007,1999,3.2,2,1,1,0,1,0,5,0.0,5,4,1,3,1,3,8,0,Matches
117,114,Radu Drăgușin,DF,ro Romania,22-161,2002,4.0,1,1,1,0,0,1,3,33.3,2,6,4,2,6,7,33,0,Matches
118,115,Vanja Drkušič,DF,si Slovenia,24-257,1999,4.3,12,7,11,1,0,11,13,84.6,2,3,2,1,1,13,16,0,Matches
119,116,Kwadwo Duah,FW,ch Switzerland,27-140,1997,1.2,1,1,0,0,1,1,1,100.0,0,0,0,0,1,2,0,0,Matches
120,117,Martin Dúbravka,GK,sk Slovakia,35-180,1989,4.3,0,0,0,0,0,0,0,,0,1,0,1,1,1,3,1,Matches
121,118,Ondrej Duda,MF,sk Slovakia,29-221,1994,3.5,7,3,2,4,1,4,6,66.7,2,8,3,5,3,10,5,0,Matches
122,119,Denzel Dumfries,DF,nl Netherlands,28-086,1996,5.0,7,5,4,0,3,4,7,57.1,3,5,2,3,3,10,6,0,Matches
123,120,Dávid Ďuriš,"FW,MF",sk Slovakia,25-113,1999,0.3,0,0,0,0,0,0,0,,0,0,0,0,0,0,0,0,Matches
124,121,Lasha Dvali,DF,ge Georgia,29-060,1995,4.0,8,3,7,1,0,4,7,57.1,3,6,5,1,1,9,24,0,Matches
125,122,Timi Elšnik,MF,si Slovenia,26-075,1998,4.0,13,7,7,4,2,5,7,71.4,2,6,3,3,4,17,5,0,Matches
126,123,Breel Embolo,FW,ch Switzerland,27-150,1997,3.3,3,3,0,2,1,0,0,,0,3,0,3,1,4,3,0,Matches
127,124,Christian Eriksen,"MF,FW",dk Denmark,32-150,1992,3.9,6,2,1,3,2,3,4,75.0,1,3,0,3,2,8,2,0,Matches
128,125,Eberechi Eze,"DF,MF",eng England,26-014,1998,1.1,0,0,0,0,0,0,0,,0,0,0,0,0,0,3,0,Matches
130,126,Wout Faes,DF,be Belgium,26-101,1998,4.0,10,7,5,5,0,3,3,100.0,0,5,3,2,4,14,11,2,Matches
131,127,Nicolò Fagioli,MF,it Italy,23-152,2001,1.1,3,1,2,0,1,1,2,50.0,1,1,1,0,0,3,0,0,Matches
132,128,João Félix,"MF,FW",pt Portugal,24-246,1999,1.2,0,0,0,0,0,0,4,0.0,4,0,0,0,0,0,0,0,Matches
133,129,Bruno Fernandes,MF,pt Portugal,29-309,1994,4.2,8,5,5,3,0,2,3,66.7,1,6,1,5,2,10,2,0,Matches
134,130,Attila Fiola,DF,hu Hungary,34-147,1990,2.0,3,1,2,0,1,2,2,100.0,0,1,1,0,0,3,9,0,Matches
135,131,Phil Foden,"FW,MF",eng England,24-046,2000,5.9,5,3,2,2,1,1,4,25.0,3,5,0,5,1,6,2,0,Matches
136,132,Youssouf Fofana,MF,fr France,25-185,1999,0.5,1,1,1,0,0,0,3,0.0,3,0,0,0,1,2,1,0,Matches
137,133,Michael Folorunsho,FW,it Italy,26-157,1998,0.0,0,0,0,0,0,0,0,,0,0,0,0,0,0,0,0,Matches
138,134,Przemysław Frankowski,DF,pl Poland,29-092,1995,3.0,7,5,6,0,1,3,12,25.0,9,1,0,1,1,8,12,0,Matches
139,135,Davide Frattesi,MF,it Italy,24-265,1999,2.1,2,1,1,1,0,1,2,50.0,1,0,0,0,0,2,1,0,Matches
140,136,Remo Freuler,MF,ch Switzerland,32-089,1992,5.1,8,5,3,3,2,1,7,14.3,6,8,0,8,4,12,10,0,Matches
141,137,Jeremie Frimpong,FW,nl Netherlands,23-216,2000,1.0,0,0,0,0,0,0,1,0.0,1,0,0,0,0,0,1,0,Matches
142,138,Chris Führich,FW,de Germany,26-186,1998,0.2,1,1,0,0,1,1,1,100.0,0,2,0,2,0,1,0,0,Matches
143,139,Niclas Füllkrug,FW,de Germany,31-155,1993,1.8,1,0,0,0,1,1,1,100.0,0,0,0,0,0,1,3,0,Matches
144,140,Mijat Gaćinović,DF,rs Serbia,29-156,1995,0.5,1,1,1,0,0,1,2,50.0,1,2,0,2,0,1,0,0,Matches
145,141,Cody Gakpo,FW,nl Netherlands,25-067,1999,5.8,9,8,3,4,2,2,12,16.7,10,5,0,5,4,13,5,0,Matches
146,142,Conor Gallagher,MF,eng England,24-158,2000,1.3,1,0,1,0,0,0,2,0.0,2,3,1,2,1,2,4,1,Matches
147,143,Dániel Gazdag,MF,hu Hungary,28-133,1996,0.0,1,1,1,0,0,0,0,,0,0,0,0,0,1,0,0,Matches
148,144,Lutsharel Geertruida,DF,nl Netherlands,23-361,2000,1.2,4,3,3,1,0,0,0,,0,2,0,2,0,4,0,0,Matches
149,145,Billy Gilmour,MF,sct Scotland,23-032,2001,2.0,1,1,0,1,0,0,0,,0,2,0,2,0,1,2,0,Matches
150,146,Olivier Giroud,FW,fr France,37-287,1986,0.7,1,0,0,0,1,0,0,,0,0,0,0,0,1,1,0,Matches
151,147,Klaus Gjasula,MF,al Albania,34-212,1989,0.2,0,0,0,0,0,0,2,0.0,2,1,0,1,0,0,0,0,Matches
152,148,Adam Gnezda Čerin,MF,si Slovenia,24-363,1999,4.3,9,5,8,1,0,4,9,44.4,5,7,0,7,5,14,10,0,Matches
153,149,Anthony Gordon,FW,eng England,23-140,2001,0.0,0,0,0,0,0,0,0,,0,0,0,0,0,0,0,0,Matches
154,150,Jon Gorenc Stanković,MF,si Slovenia,28-181,1996,1.0,1,1,1,0,0,0,1,0.0,1,3,3,0,0,1,2,0,Matches
156,151,Michael Gregoritsch,FW,at Austria,30-086,1994,1.4,1,1,0,1,0,1,2,50.0,1,1,0,1,0,1,0,0,Matches
157,152,Antoine Griezmann,"MF,FW",fr France,33-114,1991,4.4,5,3,2,2,1,4,6,66.7,2,4,0,4,1,6,2,1,Matches
158,153,Florian Grillitsch,MF,at Austria,28-341,1995,2.2,2,1,1,0,1,1,3,33.3,2,0,0,0,6,8,0,0,Matches
159,154,Álex Grimaldo,DF,es Spain,28-297,1995,1.3,1,1,1,0,0,1,2,50.0,1,1,0,1,3,4,4,0,Matches
160,155,Pascal Groß,MF,de Germany,33-028,1991,0.5,1,1,0,1,0,0,0,,0,0,0,0,0,1,0,0,Matches
161,156,Kamil Grosicki,MF,pl Poland,36-035,1988,0.2,0,0,0,0,0,0,0,,0,1,0,1,0,0,0,0,Matches
162,157,Nemanja Gudelj,MF,rs Serbia,32-240,1991,1.0,1,0,1,0,0,1,1,100.0,0,0,0,0,1,2,1,0,Matches
163,158,Marc Guéhi,DF,eng England,24-000,2000,5.3,2,2,0,1,1,0,1,0.0,1,8,5,3,2,4,8,0,Matches
164,159,Péter Gulácsi,GK,hu Hungary,34-068,1990,3.0,0,0,0,0,0,0,1,0.0,1,0,0,0,0,0,3,0,Matches
165,160,Arda Güler,"FW,MF",tr Türkiye,19-139,2005,3.8,9,5,5,2,2,7,11,63.6,4,0,0,0,3,12,0,0,Matches
166,161,İlkay Gündoğan,MF,de Germany,33-263,1990,4.3,5,4,1,3,1,0,2,0.0,2,0,0,0,1,6,0,0,Matches
167,162,Angus Gunn,GK,sct Scotland,28-173,1996,3.0,0,0,0,0,0,0,0,,0,0,0,0,0,0,4,0,Matches
168,163,Mert Günok,GK,tr Türkiye,35-134,1989,4.0,0,0,0,0,0,0,0,,0,0,0,0,0,0,1,2,Matches
169,164,Joško Gvardiol,DF,hr Croatia,22-172,2002,3.0,5,3,3,1,1,2,4,50.0,2,2,1,1,5,10,4,0,Matches
170,165,Giorgi Gwelesiani,DF,ge Georgia,33-069,1991,1.8,3,3,3,0,0,3,5,60.0,2,3,3,0,2,5,15,1,Matches
171,166,Norbert Gyömbér,DF,sk Slovakia,32-010,1992,0.4,0,0,0,0,0,0,0,,0,0,0,0,1,1,2,0,Matches
172,167,Ianis Hagi,MF,ro Romania,25-265,1998,2.1,5,3,2,1,2,2,4,50.0,2,1,0,1,0,5,4,0,Matches
173,168,Dávid Hancko,DF,sk Slovakia,26-213,1997,4.1,10,5,6,4,0,4,11,36.4,7,7,2,5,3,13,10,0,Matches
174,169,Grant Hanley,DF,sct Scotland,32-236,1991,2.5,2,0,1,1,0,0,0,,0,2,1,1,1,3,11,0,Matches
175,170,Lukáš Haraslín,FW,sk Slovakia,28-048,1996,2.9,4,4,2,1,1,4,6,66.7,2,1,0,1,3,7,5,0,Matches
176,171,Kai Havertz,"FW,MF",de Germany,25-032,1999,4.3,2,1,1,1,0,2,2,100.0,0,4,0,4,0,2,8,0,Matches
177,172,Jack Hendry,DF,sct Scotland,29-067,1995,2.9,2,1,1,1,0,2,2,100.0,0,2,2,0,1,3,10,0,Matches
178,173,Benjamin Henrichs,DF,de Germany,27-141,1997,0.1,0,0,0,0,0,0,0,,0,0,0,0,0,0,0,0,Matches
179,174,Theo Hernández,DF,fr France,26-281,1997,6.3,10,6,7,2,1,6,9,66.7,3,6,5,1,3,13,12,2,Matches
180,175,Morten Hjulmand,MF,dk Denmark,25-018,1999,2.7,3,1,1,2,0,2,5,40.0,3,3,1,2,1,4,3,1,Matches
182,176,Adam Hložek,MF,cz Czechia,21-354,2002,1.2,1,0,0,0,1,0,1,0.0,1,0,0,0,1,2,1,0,Matches
183,177,Tomáš Holeš,DF,cz Czechia,31-104,1993,3.0,10,5,5,3,2,7,10,70.0,3,4,2,2,2,12,12,0,Matches
184,178,Arbër Hoxha,"FW,MF",al Albania,25-281,1998,0.6,2,2,1,1,0,2,2,100.0,0,0,0,0,0,2,0,0,Matches
185,179,Robin Hranáč,DF,cz Czechia,24-166,2000,3.0,2,1,1,1,0,2,2,100.0,0,3,1,2,0,2,12,1,Matches
186,180,Elseid Hysaj,DF,al Albania,30-144,1994,2.0,1,1,0,1,0,1,5,20.0,4,3,2,1,0,1,2,0,Matches
187,181,Pierre Højbjerg,MF,dk Denmark,28-343,1995,3.9,10,7,5,5,0,7,13,53.8,6,5,0,5,3,13,5,0,Matches
188,182,Rasmus Højlund,FW,dk Denmark,21-160,2003,3.2,3,1,0,1,2,1,4,25.0,3,0,0,0,1,4,1,0,Matches
189,183,Ivan Ilić,MF,rs Serbia,23-118,2001,2.2,6,4,4,1,1,3,3,100.0,0,4,3,1,0,6,3,1,Matches
190,184,Josip Iličić,"FW,MF",si Slovenia,36-166,1988,0.3,2,1,1,0,1,1,1,100.0,0,0,0,0,0,2,0,0,Matches
191,185,Gonçalo Inácio,DF,pt Portugal,22-323,2001,1.3,2,2,1,1,0,2,5,40.0,3,6,0,6,1,3,5,0,Matches
192,186,Luka Ivanušec,MF,hr Croatia,25-230,1998,0.2,0,0,0,0,0,0,0,,0,0,0,0,0,0,1,0,Matches
193,187,Erik Janža,DF,si Slovenia,31-022,1993,3.0,4,4,3,1,0,1,5,20.0,4,1,1,0,2,6,8,0,Matches
194,188,Jorginho,MF,it Italy,32-206,1991,2.4,6,2,6,0,0,3,8,37.5,5,3,0,3,4,10,1,0,Matches
195,189,Joselu,FW,es Spain,34-108,1990,1.0,0,0,0,0,0,0,1,0.0,1,1,0,1,0,0,3,0,Matches
196,190,Diogo Jota,"FW,MF",pt Portugal,27-222,1996,1.1,3,2,0,2,1,0,0,,0,1,0,1,0,3,0,0,Matches
197,191,Luka Jović,"MF,FW",rs Serbia,26-203,1997,1.1,0,0,0,0,0,0,0,,0,0,0,0,0,0,1,0,Matches
198,192,Josip Juranović,DF,hr Croatia,28-332,1995,1.0,3,3,1,2,0,2,3,66.7,1,1,1,0,1,4,1,0,Matches
199,193,David Jurásek,DF,cz Czechia,23-341,2000,1.8,3,2,2,1,0,2,5,40.0,3,1,1,0,1,4,2,0,Matches
200,194,Matěj Jurásek,"DF,MF",cz Czechia,20-318,2003,0.5,2,1,0,1,1,2,4,50.0,2,0,0,0,0,2,1,0,Matches
201,195,Ferdi Kadioglu,"DF,MF",tr Türkiye,24-280,1999,5.0,18,12,9,7,2,10,13,76.9,3,5,1,4,7,25,10,0,Matches
202,196,İrfan Kahveci,FW,tr Türkiye,28-364,1995,0.1,0,0,0,0,0,0,0,,0,0,0,0,0,0,0,0,Matches
203,197,Otar Kakabadze,"DF,MF",ge Georgia,29-016,1995,4.0,12,8,10,1,1,10,18,55.6,8,3,1,2,4,16,8,0,Matches
204,198,Harry Kane,FW,eng England,30-351,1993,6.0,4,3,2,2,0,1,3,33.3,2,1,1,0,1,5,0,0,Matches
205,199,N'Golo Kanté,MF,fr France,33-106,1991,5.7,12,9,6,3,3,4,5,80.0,1,6,1,5,6,18,7,0,Matches
206,200,Žan Karničnik,DF,si Slovenia,29-299,1994,4.3,8,4,7,1,0,7,12,58.3,5,5,3,2,8,16,11,0,Matches
208,201,Guram Kashia,DF,ge Georgia,37-009,1987,4.0,7,4,5,2,0,4,4,100.0,0,13,12,1,1,8,31,1,Matches
209,202,Milos Kerkez,DF,hu Hungary,20-249,2003,2.6,4,2,3,1,0,3,5,60.0,2,0,0,0,0,4,7,1,Matches
210,203,Semih Kılıçsoy,FW,tr Türkiye,18-333,2005,0.0,0,0,0,0,0,0,0,,0,0,0,0,0,0,0,0,Matches
211,204,Joshua Kimmich,DF,de Germany,29-156,1995,5.3,7,4,5,0,2,4,12,33.3,8,6,2,4,6,13,6,0,Matches
212,205,Otar Kiteishvili,MF,ge Georgia,28-109,1996,1.4,4,4,4,0,0,2,6,33.3,4,3,1,2,0,4,3,0,Matches
213,206,Jakub Kiwior,DF,pl Poland,24-149,2000,3.0,7,4,6,1,0,3,5,60.0,2,4,2,2,5,12,9,0,Matches
214,207,László Kleinheisler,MF,hu Hungary,30-096,1994,0.6,0,0,0,0,0,0,1,0.0,1,0,0,0,0,0,0,0,Matches
215,208,Giorgi Kochorashvili,MF,ge Georgia,25-014,1999,4.0,9,5,5,4,0,5,6,83.3,1,6,4,2,5,14,6,1,Matches
216,209,Orkun Kökçü,MF,tr Türkiye,23-197,2000,2.5,3,2,2,0,1,1,4,25.0,3,3,1,2,1,4,2,0,Matches
217,210,Randal Kolo Muani,FW,fr France,25-221,1998,2.2,1,0,1,0,0,1,1,100.0,0,2,1,1,1,2,4,0,Matches
218,211,Yukhym Konoplia,DF,ua Ukraine,24-322,1999,0.8,1,0,0,0,1,0,0,,0,1,0,1,0,1,0,0,Matches
219,212,Ezri Konsa,DF,eng England,26-264,1997,1.0,2,0,2,0,0,1,1,100.0,0,3,2,1,0,2,8,0,Matches
220,213,Filip Kostić,DF,rs Serbia,31-255,1992,0.5,1,0,1,0,0,1,2,50.0,1,1,0,1,0,1,1,0,Matches
221,214,Jules Koundé,DF,fr France,25-244,1998,6.3,18,12,7,5,6,10,17,58.8,7,5,0,5,2,20,22,0,Matches
222,215,Mateo Kovačić,MF,hr Croatia,30-068,1994,2.5,8,6,2,5,1,2,5,40.0,3,2,1,1,3,11,0,0,Matches
223,216,Matej Kovar,GK,cz Czechia,24-057,2000,0.4,0,0,0,0,0,0,0,,0,0,0,0,0,0,0,0,Matches
224,217,Andrej Kramarić,FW,hr Croatia,33-024,1991,2.7,0,0,0,0,0,0,0,,0,3,1,2,1,1,1,0,Matches
225,218,Ladislav Krejčí,DF,cz Czechia,25-084,1999,3.0,3,2,3,0,0,0,3,0.0,3,1,1,0,5,8,9,0,Matches
226,219,Toni Kroos,MF,de Germany,34-191,1990,5.2,9,4,4,4,1,3,5,60.0,2,3,0,3,7,16,5,0,Matches
227,220,Jan Kuchta,FW,cz Czechia,27-187,1997,1.1,2,1,2,0,0,1,1,100.0,0,0,0,0,0,2,2,0,Matches
228,221,Juraj Kucka,MF,sk Slovakia,37-138,1987,3.9,1,1,0,1,0,1,7,14.3,6,3,1,2,2,3,4,0,Matches
229,222,Jasmin Kurtić,FW,si Slovenia,35-185,1989,0.0,0,0,0,0,0,0,0,,0,0,0,0,0,0,0,0,Matches
230,223,Khvicha Kvaratskhelia,FW,ge Georgia,23-152,2001,3.8,4,3,0,4,0,3,6,50.0,3,2,2,0,0,4,2,0,Matches
231,224,Nika Kvekveskiri,MF,ge Georgia,32-045,1992,0.1,0,0,0,0,0,0,1,0.0,1,0,0,0,1,1,0,0,Matches
232,225,Giorgi Kvilitaia,FW,ge Georgia,30-286,1993,0.0,0,0,0,0,0,0,0,,0,0,0,0,0,0,0,0,Matches
234,226,Saba Kvirkvelia,DF,ge Georgia,32-158,1992,2.0,4,3,3,1,0,3,3,100.0,0,2,2,0,1,5,17,1,Matches
235,227,Qazim Laçi,"MF,FW",al Albania,28-176,1996,1.8,4,3,1,2,1,1,2,50.0,1,3,0,3,3,7,5,0,Matches
236,228,Konrad Laimer,"MF,FW",at Austria,27-047,1997,3.0,5,1,2,1,2,3,6,50.0,3,3,0,3,2,7,2,0,Matches
237,229,Ádám Lang,DF,hu Hungary,31-178,1993,0.5,0,0,0,0,0,0,0,,0,0,0,0,1,1,3,0,Matches
238,230,Aymeric Laporte,DF,es Spain,30-047,1994,4.8,3,3,2,1,0,2,3,66.7,1,4,3,1,5,8,21,1,Matches
239,231,Robin Le Normand,DF,es Spain,27-245,1996,4.0,6,2,5,1,0,5,8,62.5,3,2,1,1,2,8,11,0,Matches
240,232,Rafael Leão,FW,pt Portugal,25-033,1999,3.2,2,2,2,0,0,1,2,50.0,1,1,0,1,1,3,1,0,Matches
241,233,Robert Lewandowski,FW,pl Poland,35-327,1988,1.3,2,2,0,0,2,0,0,,0,2,0,2,0,2,3,0,Matches
242,234,Philipp Lienhart,DF,at Austria,28-002,1996,2.4,2,2,1,1,0,2,3,66.7,1,2,2,0,2,4,10,0,Matches
243,235,Ondřej Lingr,"MF,FW",cz Czechia,25-280,1998,0.9,2,2,0,2,0,0,1,0.0,1,1,0,1,0,2,0,0,Matches
244,236,Dominik Livaković,GK,hr Croatia,29-186,1995,3.0,0,0,0,0,0,0,0,,0,0,0,0,1,1,2,0,Matches
245,237,Stanislav Lobotka,MF,sk Slovakia,29-231,1994,4.3,7,6,3,4,0,2,6,33.3,4,3,0,3,3,10,9,0,Matches
246,238,Saba Lobzhanidze,FW,ge Georgia,29-208,1994,0.1,0,0,0,0,0,0,0,,0,0,0,0,0,0,3,0,Matches
247,239,Luka Lochoshvili,"DF,MF",ge Georgia,26-045,1998,1.9,4,3,3,0,1,3,5,60.0,2,1,0,1,3,7,11,0,Matches
248,240,Fermin López,MF,es Spain,21-063,2003,0.3,1,1,0,0,1,0,1,0.0,1,0,0,0,0,1,0,0,Matches
249,241,Romelu Lukaku,FW,be Belgium,31-061,1993,4.0,0,0,0,0,0,0,0,,0,0,0,0,0,0,3,0,Matches
250,242,Dodi Lukebakio,"FW,DF",be Belgium,26-293,1997,0.7,1,1,0,0,1,0,0,,0,1,0,1,0,1,0,0,Matches
251,243,Saša Lukić,MF,rs Serbia,27-335,1996,2.3,8,5,1,5,2,5,6,83.3,1,2,0,2,3,11,5,0,Matches
252,244,Andriy Lunin,GK,ua Ukraine,25-153,1999,1.0,0,0,0,0,0,0,0,,0,0,0,0,0,0,0,2,Matches
253,245,Mike Maignan,GK,fr France,29-010,1995,6.3,1,0,1,0,0,1,1,100.0,0,0,0,0,0,1,5,0,Matches
254,246,Kobbie Mainoo,MF,eng England,19-085,2005,3.3,6,4,1,4,1,3,4,75.0,1,0,0,0,6,12,1,0,Matches
255,247,Lovro Majer,"FW,MF",hr Croatia,26-178,1998,1.6,4,3,1,2,1,2,2,100.0,0,4,0,4,0,4,0,0,Matches
256,248,Donyell Malen,FW,nl Netherlands,25-186,1999,2.1,0,0,0,0,0,0,0,,0,0,0,0,2,2,2,0,Matches
257,249,Ruslan Malinovskyi,MF,ua Ukraine,31-070,1993,0.4,5,1,1,4,0,1,3,33.3,2,1,0,1,1,6,3,0,Matches
258,250,Giorgi Mamardashvili,GK,ge Georgia,23-288,2000,4.0,0,0,0,0,0,0,0,,0,0,0,0,0,0,2,0,Matches
260,251,Dennis Man,MF,ro Romania,25-322,1998,3.0,3,0,1,2,0,2,4,50.0,2,0,0,0,1,4,0,0,Matches
261,252,Rey Manaj,FW,al Albania,27-140,1997,1.7,2,2,1,0,1,0,1,0.0,1,0,0,0,1,3,2,0,Matches
262,253,Gianluca Mancini,DF,it Italy,28-087,1996,1.0,0,0,0,0,0,0,0,,0,3,1,2,0,0,1,0,Matches
263,254,Orel Mangala,MF,be Belgium,26-117,1998,1.5,4,3,2,1,1,1,3,33.3,2,2,1,1,4,8,0,0,Matches
264,255,Marius Marin,MF,ro Romania,25-318,1998,3.4,9,3,8,1,0,5,10,50.0,5,4,1,3,4,13,6,0,Matches
265,256,Răzvan Marin,MF,ro Romania,28-051,1996,3.9,7,2,3,4,0,4,9,44.4,5,3,2,1,0,7,6,0,Matches
266,257,Ádám Martin,"FW,DF",hu Hungary,29-250,1994,0.5,0,0,0,0,0,0,0,,0,2,2,0,0,0,0,0,Matches
267,258,Mykola Matviyenko,DF,ua Ukraine,28-072,1996,3.0,4,3,2,2,0,2,4,50.0,2,4,2,2,4,8,9,1,Matches
268,259,Kylian Mbappé,FW,fr France,25-206,1998,5.2,1,0,1,0,0,0,2,0.0,2,4,1,3,0,1,0,0,Matches
269,260,John McGinn,"MF,FW",sct Scotland,29-269,1994,2.6,1,1,0,1,0,1,4,25.0,3,2,0,2,1,2,0,0,Matches
270,261,Callum McGregor,MF,sct Scotland,31-029,1993,2.7,2,1,1,1,0,1,4,25.0,3,2,1,1,2,4,6,0,Matches
271,262,Scott McKenna,DF,sct Scotland,27-244,1996,1.5,1,0,1,0,0,1,2,50.0,1,1,1,0,2,3,5,0,Matches
272,263,Kenny McLean,MF,sct Scotland,32-187,1992,0.5,3,2,1,2,0,3,3,100.0,0,0,0,0,0,3,0,0,Matches
273,264,Scott McTominay,MF,sct Scotland,27-218,1996,3.0,4,2,2,1,1,1,2,50.0,1,2,1,1,3,7,7,0,Matches
274,265,Anzor Mekvabishvili,MF,ge Georgia,23-038,2001,2.1,6,3,3,3,0,3,3,100.0,0,4,1,3,5,11,5,0,Matches
275,266,Memphis,"FW,MF",nl Netherlands,30-151,1994,5.1,1,1,0,1,0,1,4,25.0,3,1,0,1,1,2,1,0,Matches
276,267,Nuno Mendes,DF,pt Portugal,22-024,2002,4.7,12,6,7,3,2,6,11,54.5,5,6,2,4,5,17,11,0,Matches
277,268,Mikel Merino,"MF,FW",es Spain,28-021,1996,2.0,4,3,0,3,1,2,3,66.7,1,2,1,1,2,6,4,0,Matches
278,269,Valentin Mihaila,MF,ro Romania,24-162,2000,1.3,3,2,2,0,1,0,1,0.0,1,0,0,0,2,5,5,0,Matches
279,270,Srđan Mijailović,DF,rs Serbia,30-246,1993,0.8,3,1,1,2,0,3,4,75.0,1,1,0,1,1,4,4,0,Matches
280,271,Georges Mikautadze,FW,ge Georgia,23-256,2000,3.8,3,1,1,2,0,1,4,25.0,3,0,0,0,0,3,0,0,Matches
281,272,Nikola Milenković,DF,rs Serbia,26-275,1997,3.0,3,3,1,2,0,1,2,50.0,1,2,2,0,2,5,11,0,Matches
282,273,Sergej Milinković-Savić,MF,rs Serbia,29-137,1995,1.3,2,2,0,2,0,1,2,50.0,1,1,1,0,1,3,2,0,Matches
283,274,Mario Mitaj,DF,al Albania,20-342,2003,3.0,8,4,6,1,1,8,11,72.7,3,4,0,4,7,15,11,0,Matches
284,275,Aleksandar Mitrović,FW,rs Serbia,29-301,1994,2.7,0,0,0,0,0,0,1,0.0,1,2,0,2,0,0,4,0,Matches
286,276,Maximilian Mittelstädt,DF,de Germany,27-117,1997,3.4,4,2,1,1,2,3,5,60.0,2,6,0,6,2,6,8,0,Matches
287,277,Filip Mladenović,DF,rs Serbia,32-333,1991,1.2,2,1,0,1,1,1,5,20.0,4,0,0,0,2,4,1,0,Matches
288,278,Jan Mlakar,MF,si Slovenia,25-264,1998,3.3,3,3,2,1,0,1,2,50.0,1,2,1,1,1,4,9,0,Matches
289,279,Jakub Moder,MF,pl Poland,25-097,1999,2.0,2,2,0,2,0,1,3,33.3,2,3,1,2,1,3,8,0,Matches
290,280,Luka Modrić,MF,hr Croatia,38-308,1985,2.6,4,4,4,0,0,1,2,50.0,1,1,0,1,1,5,1,0,Matches
291,281,Vasile Mogos,DF,ro Romania,31-256,1992,0.4,0,0,0,0,0,0,1,0.0,1,0,0,0,0,0,1,0,Matches
292,282,Álvaro Morata,FW,es Spain,31-264,1992,4.2,6,4,1,2,3,0,4,0.0,4,0,0,0,0,6,2,0,Matches
293,283,Lewis Morgan,DF,sct Scotland,27-287,1996,0.0,0,0,0,0,0,0,0,,0,0,0,0,1,1,0,0,Matches
294,284,Ernest Muçi,FW,al Albania,23-116,2001,0.2,0,0,0,0,0,0,0,,0,0,0,0,0,0,0,0,Matches
295,285,Mykhailo Mudryk,"FW,MF",ua Ukraine,23-190,2001,1.9,2,2,1,0,1,2,4,50.0,2,0,0,0,0,2,1,1,Matches
296,286,Mert Müldür,"DF,MF",tr Türkiye,25-101,1999,3.8,7,6,3,1,3,7,9,77.8,2,8,1,7,5,12,12,0,Matches
297,287,Thomas Müller,"MF,FW",de Germany,34-304,1989,0.6,2,1,1,1,0,1,2,50.0,1,0,0,0,0,2,1,0,Matches
298,288,Jamal Musiala,FW,de Germany,21-138,2003,4.7,6,4,1,4,1,2,3,66.7,1,7,0,7,4,10,2,0,Matches
299,289,Phillipp Mwene,DF,at Austria,30-166,1994,2.2,6,4,3,3,0,3,6,50.0,3,5,2,3,0,6,6,0,Matches
300,290,Vitaliy Mykolenko,DF,ua Ukraine,25-045,1999,0.6,0,0,0,0,0,0,0,,0,2,1,1,0,0,1,0,Matches
301,291,Joakim Mæhle,"DF,MF",dk Denmark,27-054,1997,3.1,6,4,3,2,1,3,8,37.5,5,2,0,2,3,9,5,1,Matches
302,292,Nacho,DF,es Spain,34-177,1990,2.8,2,1,1,1,0,1,3,33.3,2,3,2,1,0,2,15,0,Matches
303,293,Ádám Nagy,MF,hu Hungary,29-026,1995,1.8,3,2,2,1,0,2,2,100.0,0,1,0,1,4,7,3,0,Matches
304,294,Zsolt Nagy,DF,hu Hungary,31-049,1993,0.2,2,0,1,1,0,0,0,,0,0,0,0,0,2,2,0,Matches
305,295,Jesús Navas,DF,es Spain,38-235,1985,1.7,3,2,1,2,0,0,0,,0,2,0,2,1,4,11,0,Matches
306,296,Dan Ndoye,"MF,DF",ch Switzerland,23-262,2000,4.5,5,3,4,1,0,1,2,50.0,1,3,0,3,2,7,2,0,Matches
307,297,Pedro Neto,"DF,FW",pt Portugal,24-126,2000,1.3,5,1,2,2,1,2,2,100.0,0,0,0,0,2,7,1,0,Matches
308,298,Manuel Neuer,GK,de Germany,38-108,1986,5.3,0,0,0,0,0,0,0,,0,0,0,0,0,0,1,1,Matches
309,299,João Neves,MF,pt Portugal,19-290,2004,0.9,0,0,0,0,0,0,0,,0,1,0,1,5,5,0,0,Matches
310,300,Rúben Neves,MF,pt Portugal,27-122,1997,1.4,3,1,0,2,1,0,1,0.0,1,3,1,2,1,4,1,0,Matches
312,301,Florin Niță,GK,ro Romania,37-010,1987,4.0,0,0,0,0,0,0,0,,0,0,0,0,0,0,2,0,Matches
313,302,Matheus Nunes,MF,pt Portugal,25-321,1998,0.2,0,0,0,0,0,0,0,,0,0,0,0,0,0,0,0,Matches
314,303,Christian Nørgaard,MF,dk Denmark,30-125,1994,0.4,1,0,0,1,0,1,1,100.0,0,0,0,0,0,1,1,0,Matches
315,304,Adam Obert,DF,sk Slovakia,21-325,2002,0.3,1,1,0,1,0,1,1,100.0,0,0,0,0,0,1,1,0,Matches
316,305,Jan Oblak,GK,si Slovenia,31-188,1993,4.3,0,0,0,0,0,0,0,,0,0,0,0,0,0,1,0,Matches
317,306,Darius Olaru,MF,ro Romania,26-132,1998,0.3,0,0,0,0,0,0,0,,0,0,0,0,0,0,0,0,Matches
318,307,Dani Olmo,"MF,FW",es Spain,26-067,1998,3.8,3,3,1,1,1,3,5,60.0,2,1,0,1,2,5,2,0,Matches
319,308,Amadou Onana,MF,be Belgium,22-332,2001,4.0,8,6,3,4,1,4,5,80.0,1,7,1,6,3,11,4,2,Matches
320,309,Loïs Openda,FW,be Belgium,24-148,2000,0.8,2,1,0,0,2,0,0,,0,1,0,1,1,3,1,0,Matches
321,310,Willi Orban,DF,hu Hungary,31-253,1992,3.0,7,7,7,0,0,3,3,100.0,0,9,7,2,1,8,9,1,Matches
322,311,Mikel Oyarzabal,FW,es Spain,27-083,1997,2.0,1,0,0,0,1,0,0,,0,2,0,2,0,1,4,0,Matches
323,312,Salih Özcan,MF,tr Türkiye,26-184,1998,1.7,6,3,1,5,0,2,3,66.7,1,0,0,0,7,13,4,0,Matches
324,313,João Palhinha,MF,pt Portugal,29-004,1995,3.3,15,9,5,8,2,7,10,70.0,3,6,1,5,8,23,6,0,Matches
325,314,Cole Palmer,"MF,FW",eng England,22-068,2002,1.4,1,0,1,0,0,1,2,50.0,1,1,0,1,0,1,0,0,Matches
326,315,Mario Pašalić,"FW,MF",hr Croatia,29-155,1995,1.3,1,0,1,0,0,0,0,,0,0,0,0,0,1,2,0,Matches
327,316,Strahinja Pavlović,DF,rs Serbia,23-050,2001,3.0,11,6,7,3,1,9,14,64.3,5,2,0,2,4,15,10,0,Matches
328,317,Pedri,MF,es Spain,21-231,2002,2.1,6,3,1,4,1,2,4,50.0,2,0,0,0,1,7,0,0,Matches
329,318,Peter Pekarík,DF,sk Slovakia,37-257,1986,4.2,1,0,1,0,0,1,4,25.0,3,4,3,1,7,8,11,0,Matches
330,319,Lorenzo Pellegrini,"FW,MF",it Italy,28-024,1996,2.4,2,0,1,1,0,1,4,25.0,3,3,0,3,2,4,2,0,Matches
331,320,Patrick Pentz,GK,at Austria,27-193,1997,4.0,0,0,0,0,0,0,0,,0,0,0,0,0,0,3,1,Matches
332,321,Pepe,DF,pt Portugal,41-138,1983,4.5,9,5,5,3,1,7,13,53.8,6,3,2,1,5,14,26,1,Matches
333,322,Danilo Pereira,DF,pt Portugal,32-308,1991,1.0,0,0,0,0,0,0,0,,0,0,0,0,1,1,2,0,Matches
334,323,Ayoze Pérez,FW,es Spain,30-350,1993,0.1,0,0,0,0,0,0,0,,0,1,0,1,0,0,0,0,Matches
335,324,Ivan Perišić,"DF,FW",hr Croatia,35-162,1989,1.5,0,0,0,0,0,0,0,,0,1,0,1,1,1,3,0,Matches
336,325,Bruno Petković,FW,hr Croatia,29-301,1994,1.0,0,0,0,0,0,0,1,0.0,1,0,0,0,0,0,1,0,Matches
338,326,Krzysztof Piątek,FW,pl Poland,29-012,1995,0.7,1,1,0,1,0,0,0,,0,0,0,0,0,1,0,0,Matches
339,327,Jordan Pickford,GK,eng England,30-128,1994,6.7,0,0,0,0,0,0,0,,0,0,0,0,0,0,1,0,Matches
340,328,Jakub Piotrowski,MF,pl Poland,26-283,1997,0.6,0,0,0,0,0,0,0,,0,0,0,0,0,0,1,0,Matches
341,329,Marin Pongračić,DF,hr Croatia,26-306,1997,2.0,2,1,2,0,0,0,4,0.0,4,6,3,3,2,4,9,0,Matches
342,330,Ryan Porteous,DF,sct Scotland,25-110,1999,0.5,2,1,2,0,0,2,2,100.0,0,0,0,0,0,2,1,0,Matches
343,331,Stefan Posch,DF,at Austria,27-060,1997,4.0,15,9,4,8,3,9,13,69.2,4,11,4,7,6,21,11,0,Matches
344,332,Yussuf Poulsen,"FW,MF",dk Denmark,30-028,1994,0.6,1,0,0,0,1,1,2,50.0,1,1,0,1,0,1,1,0,Matches
345,333,Alexander Prass,DF,at Austria,23-048,2001,1.8,7,2,4,2,1,4,10,40.0,6,1,0,1,2,9,1,0,Matches
346,334,Lukáš Provod,MF,cz Czechia,27-264,1996,2.6,5,5,2,1,2,3,5,60.0,2,3,1,2,0,5,2,0,Matches
347,335,George Pușcaș,FW,ro Romania,28-096,1996,0.4,0,0,0,0,0,0,1,0.0,1,0,0,0,0,0,1,0,Matches
348,336,Leopold Querfeld,DF,at Austria,20-206,2003,0.3,2,2,1,1,0,2,2,100.0,0,0,0,0,1,3,1,0,Matches
349,337,Adrien Rabiot,MF,fr France,29-101,1995,4.1,9,5,3,5,1,4,5,80.0,1,3,0,3,1,10,2,0,Matches
350,338,Bogdan Racovitan,DF,ro Romania,24-037,2000,0.6,0,0,0,0,0,0,1,0.0,1,2,2,0,1,1,3,1,Matches
351,339,Predrag Rajković,GK,rs Serbia,28-256,1995,3.0,0,0,0,0,0,0,0,,0,0,0,0,0,0,0,0,Matches
352,340,Anthony Ralston,DF,sct Scotland,25-240,1998,2.9,3,2,3,0,0,1,3,33.3,2,5,1,4,1,4,7,1,Matches
353,341,Ylber Ramadani,MF,al Albania,28-092,1996,2.9,6,3,2,3,1,5,9,55.6,4,8,3,5,4,10,4,0,Matches
354,342,Gonçalo Ramos,FW,pt Portugal,23-023,2001,0.3,0,0,0,0,0,0,0,,0,1,0,1,0,0,1,0,Matches
355,343,Giacomo Raspadori,FW,it Italy,24-146,2000,0.9,3,1,1,2,0,1,2,50.0,1,0,0,0,0,3,0,0,Matches
356,344,Andrei Ratiu,DF,ro Romania,26-023,1998,4.0,6,5,4,2,0,4,5,80.0,1,6,2,4,6,12,15,0,Matches
357,345,David Raum,DF,de Germany,26-082,1998,1.8,5,5,3,1,1,5,7,71.4,2,1,0,1,0,5,1,0,Matches
358,346,David Raya,GK,es Spain,28-302,1995,1.0,0,0,0,0,0,0,0,,0,0,0,0,0,0,0,0,Matches
359,347,Tijjani Reijnders,MF,nl Netherlands,25-350,1998,5.5,8,6,1,7,0,3,5,60.0,2,5,1,4,6,14,4,0,Matches
360,348,Mateo Retegui,FW,it Italy,25-075,1999,1.7,2,1,0,1,1,0,1,0.0,1,1,0,1,0,2,0,0,Matches
361,349,Declan Rice,MF,eng England,25-181,1999,6.7,18,14,10,6,2,5,8,62.5,3,3,0,3,6,24,10,0,Matches
362,350,Fabian Rieder,MF,ch Switzerland,22-148,2002,2.4,7,3,1,4,2,3,5,60.0,2,2,1,1,0,7,1,0,Matches
364,351,Andrew Robertson,DF,sct Scotland,30-124,1994,3.0,8,5,4,4,0,8,10,80.0,2,2,0,2,1,9,10,1,Matches
365,352,Rodri,MF,es Spain,28-021,1996,5.3,13,7,4,8,1,4,8,50.0,4,5,2,3,0,13,10,0,Matches
366,353,Ricardo Rodríguez,DF,ch Switzerland,31-323,1992,5.3,7,6,2,3,2,3,4,75.0,1,5,2,3,3,10,19,0,Matches
367,354,Taras Romanchuk,MF,pl Poland,32-242,1991,0.6,2,1,2,0,0,1,2,50.0,1,1,0,1,0,2,1,0,Matches
368,355,Cristiano Ronaldo,FW,pt Portugal,39-159,1985,5.4,1,1,0,0,1,1,1,100.0,0,1,1,0,0,1,1,0,Matches
369,356,Antonio Rüdiger,DF,de Germany,31-132,1993,5.3,8,4,7,1,0,6,6,100.0,0,10,6,4,2,10,20,0,Matches
370,357,Fabián Ruiz Peña,MF,es Spain,28-101,1996,5.0,5,2,3,0,2,2,5,40.0,3,1,0,1,4,9,5,1,Matches
371,358,Adrian Rus,MF,ro Romania,28-117,1996,0.2,0,0,0,0,0,0,0,,0,0,0,0,0,0,0,0,Matches
372,359,Marcel Sabitzer,"FW,MF",at Austria,30-118,1994,4.0,2,1,0,1,1,2,2,100.0,0,2,0,2,3,5,1,0,Matches
373,360,Bukayo Saka,"FW,DF",eng England,22-312,2001,6.0,5,4,2,3,0,2,3,66.7,1,5,0,5,1,6,11,0,Matches
374,361,Bartosz Salamon,DF,pl Poland,33-073,1991,0.9,3,2,2,1,0,2,2,100.0,0,1,0,1,2,5,7,0,Matches
375,362,William Saliba,DF,fr France,23-111,2001,6.3,5,2,3,2,0,2,3,66.7,1,6,3,3,4,9,30,0,Matches
376,363,Roland Sallai,MF,hu Hungary,27-052,1997,3.0,4,2,1,1,2,1,2,50.0,1,0,0,0,1,5,1,0,Matches
377,364,Lazar Samardzic,MF,rs Serbia,22-140,2002,0.6,0,0,0,0,0,0,0,,0,0,0,0,0,0,0,0,Matches
378,365,Leroy Sané,FW,de Germany,28-184,1996,2.3,1,1,1,0,0,0,5,0.0,5,2,0,2,0,1,0,0,Matches
379,366,Leo Sauer,FW,sk Slovakia,18-210,2005,0.1,0,0,0,0,0,0,0,,0,0,0,0,0,0,0,0,Matches
380,367,Gianluca Scamacca,FW,it Italy,25-194,1999,2.8,1,1,0,0,1,0,0,,0,0,0,0,2,3,1,0,Matches
381,368,András Schäfer,MF,hu Hungary,25-091,1999,3.0,6,3,0,6,0,1,3,33.3,2,4,1,3,1,7,3,0,Matches
382,369,Fabian Schär,DF,ch Switzerland,32-206,1991,5.3,10,4,7,0,3,4,7,57.1,3,6,4,2,9,19,24,0,Matches
383,370,Patrik Schick,FW,cz Czechia,28-171,1996,1.4,1,1,1,0,0,0,3,0.0,3,1,0,1,1,2,4,0,Matches
384,371,Nico Schlotterbeck,DF,de Germany,24-225,1999,1.3,1,1,0,1,0,0,2,0.0,2,1,0,1,2,3,8,1,Matches
385,372,Kasper Schmeichel,GK,dk Denmark,37-251,1986,4.0,0,0,0,0,0,0,0,,0,0,0,0,0,0,0,0,Matches
386,373,Romano Schmid,"FW,MF",at Austria,24-168,2000,1.6,2,1,0,1,1,1,3,33.3,2,6,0,6,0,2,2,0,Matches
387,374,Jerdy Schouten,MF,nl Netherlands,27-183,1997,5.6,7,3,2,4,1,1,5,20.0,4,5,2,3,5,12,8,0,Matches
388,375,Ivan Schranz,FW,sk Slovakia,30-304,1993,3.7,3,1,3,0,0,1,3,33.3,2,0,0,0,2,5,9,0,Matches
390,376,Taulant Seferi,FW,al Albania,27-241,1996,1.0,2,2,0,2,0,2,5,40.0,3,0,0,0,2,4,2,0,Matches
391,377,Nicolas Seiwald,MF,at Austria,23-070,2001,4.0,15,7,5,8,2,4,11,36.4,7,5,1,4,6,21,8,0,Matches
392,378,Nélson Semedo,DF,pt Portugal,30-240,1993,1.1,3,2,2,1,0,2,6,33.3,4,1,0,1,0,3,0,0,Matches
393,379,Benjamin Šeško,FW,si Slovenia,21-043,2003,4.0,3,1,1,1,1,1,5,20.0,4,3,1,2,0,3,5,0,Matches
394,380,Petr Ševčík,MF,cz Czechia,30-070,1994,0.2,0,0,0,0,0,0,0,,0,0,0,0,0,0,0,0,Matches
395,381,Stephan El Shaarawy,FW,it Italy,31-260,1992,0.5,0,0,0,0,0,0,0,,0,0,0,0,0,0,2,0,Matches
396,382,Lawrence Shankland,FW,sct Scotland,28-338,1995,0.3,1,0,1,0,0,1,1,100.0,0,2,0,2,0,1,1,0,Matches
397,383,Mykola Shaparenko,MF,ua Ukraine,25-283,1998,2.4,3,0,2,1,0,3,4,75.0,1,4,0,4,3,6,1,0,Matches
398,384,Xherdan Shaqiri,"MF,FW",ch Switzerland,32-277,1991,0.8,0,0,0,0,0,0,0,,0,0,0,0,0,0,0,0,Matches
399,385,Luke Shaw,DF,eng England,29-001,1995,1.0,0,0,0,0,0,0,0,,0,0,0,0,1,1,2,0,Matches
400,386,Vincent Sierro,MF,ch Switzerland,28-279,1995,0.4,0,0,0,0,0,0,1,0.0,1,1,1,0,0,0,1,0,Matches
401,387,António Silva,DF,pt Portugal,20-257,2003,0.8,1,1,1,0,0,0,0,,0,0,0,0,0,1,2,1,Matches
402,388,Bernardo Silva,"FW,MF",pt Portugal,29-338,1994,4.7,5,4,1,3,1,1,6,16.7,5,2,0,2,0,5,3,0,Matches
403,389,Unai Simón,GK,es Spain,27-032,1997,5.3,0,0,0,0,0,0,0,,0,0,0,0,0,0,3,1,Matches
404,390,Xavi Simons,"MF,FW",nl Netherlands,21-083,2003,5.0,8,5,3,4,1,5,6,83.3,1,7,0,7,5,13,0,0,Matches
405,391,Michał Skóraś,DF,pl Poland,24-149,2000,0.3,1,1,0,1,0,0,0,,0,0,0,0,1,2,1,0,Matches
406,392,Łukasz Skorupski,GK,pl Poland,33-069,1991,1.0,0,0,0,0,0,0,0,,0,0,0,0,0,0,4,0,Matches
407,393,Andreas Skov Olsen,"MF,FW",dk Denmark,24-197,1999,1.4,1,1,0,0,1,1,2,50.0,1,2,0,2,0,1,2,0,Matches
408,394,Milan Škriniar,DF,sk Slovakia,29-153,1995,4.3,3,1,3,0,0,2,4,50.0,2,4,4,0,2,5,17,0,Matches
409,395,Bartosz Slisz,MF,pl Poland,25-106,1999,1.2,1,1,0,0,1,0,0,,0,1,0,1,2,3,3,0,Matches
410,396,Yann Sommer,GK,ch Switzerland,35-209,1988,5.3,0,0,0,0,0,0,0,,0,0,0,0,0,0,2,0,Matches
411,397,Deian Sorescu,"MF,DF",ro Romania,26-319,1997,0.4,0,0,0,0,0,0,0,,0,1,0,1,1,1,1,0,Matches
412,398,Borna Sosa,DF,hr Croatia,26-174,1998,0.1,0,0,0,0,0,0,1,0.0,1,1,1,0,0,0,0,0,Matches
413,399,Tomáš Souček,MF,cz Czechia,29-137,1995,3.0,5,3,2,2,1,3,6,50.0,3,6,2,4,3,8,5,0,Matches
414,400,Andraž Šporar,FW,si Slovenia,30-137,1994,3.8,2,2,1,0,1,1,1,100.0,0,2,1,1,0,2,4,0,Matches
416,401,Nicolae Stanciu,"MF,FW",ro Romania,31-067,1993,3.9,3,2,1,2,0,1,4,25.0,3,1,1,0,1,4,5,0,Matches
417,402,Jindřich Staněk,GK,cz Czechia,28-077,1996,2.6,0,0,0,0,0,0,0,,0,0,0,0,0,0,1,0,Matches
418,403,Josip Stanišić,DF,hr Croatia,24-102,2000,2.0,10,8,3,5,2,5,9,55.6,4,3,1,2,4,14,2,0,Matches
419,404,Renato Steffen,DF,ch Switzerland,32-253,1991,0.0,0,0,0,0,0,0,0,,0,0,0,0,0,0,0,0,Matches
420,405,Taras Stepanenko,MF,ua Ukraine,34-340,1989,0.9,3,3,3,0,0,3,5,60.0,2,2,1,1,1,4,2,0,Matches
421,406,Leonidas Stergiou,DF,ch Switzerland,22-132,2002,0.5,4,2,3,1,0,1,3,33.3,2,0,0,0,0,4,4,0,Matches
422,407,Petar Stojanović,MF,si Slovenia,28-280,1995,3.5,6,5,5,1,0,3,8,37.5,5,4,1,3,1,7,4,0,Matches
423,408,John Stones,DF,eng England,30-046,1994,6.7,4,3,2,1,1,2,2,100.0,0,2,2,0,1,5,14,0,Matches
424,409,Thomas Strakosha,GK,al Albania,29-116,1995,3.0,0,0,0,0,0,0,0,,0,0,0,0,0,0,1,0,Matches
425,410,Dávid Strelec,FW,sk Slovakia,23-100,2001,2.0,0,0,0,0,0,0,0,,0,2,0,2,0,0,0,0,Matches
426,411,Callum Styles,MF,hu Hungary,24-107,2000,0.7,0,0,0,0,0,0,1,0.0,1,0,0,0,1,1,1,0,Matches
427,412,Luka Sučić,"FW,MF",hr Croatia,21-309,2002,1.6,0,0,0,0,0,0,0,,0,4,0,4,1,1,1,0,Matches
428,413,Heorhiy Sudakov,MF,ua Ukraine,21-316,2002,2.9,3,1,2,1,0,3,4,75.0,1,4,1,3,0,3,1,0,Matches
429,414,Pavel Šulc,MF,cz Czechia,23-197,2000,0.9,1,1,1,0,0,1,2,50.0,1,1,1,0,1,2,2,0,Matches
430,415,Tomáš Suslov,"FW,MF",sk Slovakia,22-036,2002,1.4,4,1,1,3,0,1,4,25.0,3,4,0,4,1,5,0,0,Matches
431,416,Josip Šutalo,DF,hr Croatia,24-136,2000,3.0,5,3,5,0,0,2,3,66.7,1,6,5,1,13,18,7,1,Matches
432,417,Oleksandr Svatok,DF,ua Ukraine,29-290,1994,0.9,0,0,0,0,0,0,0,,0,2,1,1,3,3,2,0,Matches
433,418,Karol Świderski,FW,pl Poland,27-172,1997,1.0,0,0,0,0,0,0,0,,0,0,0,0,0,0,0,0,Matches
434,419,Serhiy Sydorchuk,MF,ua Ukraine,33-072,1991,0.1,0,0,0,0,0,0,0,,0,0,0,0,0,0,0,0,Matches
435,420,Attila Szalai,DF,hu Hungary,26-175,1998,1.1,2,2,2,0,0,1,3,33.3,2,0,0,0,2,4,2,0,Matches
436,421,Wojciech Szczęsny,GK,pl Poland,34-086,1990,2.0,0,0,0,0,0,0,1,0.0,1,1,0,1,0,0,2,0,Matches
437,422,Dominik Szoboszlai,MF,hu Hungary,23-262,2000,3.0,2,0,0,1,1,0,0,,0,4,1,3,2,4,6,0,Matches
438,423,Sebastian Szymański,MF,pl Poland,25-064,1999,1.2,7,2,5,2,0,5,10,50.0,5,3,1,2,3,10,1,0,Matches
439,424,Dušan Tadić,MF,rs Serbia,35-236,1988,1.7,2,2,0,1,1,0,0,,0,1,0,1,1,3,3,0,Matches
440,425,Jonathan Tah,DF,de Germany,28-153,1996,3.5,2,1,1,1,0,1,1,100.0,0,2,1,1,4,6,11,0,Matches
442,426,Maksym Talovierov,MF,ua Ukraine,24-015,2000,0.0,0,0,0,0,0,0,0,,0,0,0,0,0,0,0,0,Matches
443,427,Aurélien Tchouaméni,MF,fr France,24-168,2000,5.2,9,7,3,4,2,3,8,37.5,5,2,1,1,5,14,10,1,Matches
444,428,Arthur Theate,DF,be Belgium,24-049,2000,2.8,2,2,0,0,2,0,1,0.0,1,5,0,5,2,4,9,0,Matches
445,429,Marcus Thuram,FW,fr France,26-342,1997,2.9,2,2,0,0,2,0,0,,0,6,2,4,0,2,2,0,Matches
446,430,Youri Tielemans,MF,be Belgium,27-067,1997,1.6,2,2,1,1,0,0,1,0.0,1,3,1,2,1,3,0,0,Matches
447,431,Kieran Tierney,DF,sct Scotland,27-038,1997,1.5,2,1,2,0,0,1,3,33.3,2,1,1,0,0,2,4,0,Matches
448,432,Ivan Toney,FW,eng England,28-119,1996,0.5,1,1,0,1,0,0,0,,0,0,0,0,0,1,1,0,Matches
449,433,Ferrán Torres,"FW,MF",es Spain,24-135,2000,1.7,0,0,0,0,0,0,1,0.0,1,3,0,3,1,1,1,0,Matches
450,434,Cenk Tosun,FW,tr Türkiye,33-036,1991,0.3,0,0,0,0,0,0,0,,0,0,0,0,0,0,0,0,Matches
451,435,Gernot Trauner,DF,at Austria,32-110,1992,1.0,2,1,2,0,0,0,1,0.0,1,2,2,0,1,3,1,0,Matches
452,436,Kieran Trippier,DF,eng England,33-298,1990,5.0,7,4,3,3,1,3,8,37.5,5,3,1,2,5,12,8,0,Matches
453,437,Leandro Trossard,FW,be Belgium,29-222,1994,1.9,2,1,1,1,0,1,2,50.0,1,2,0,2,0,2,0,0,Matches
454,438,Anatolii Trubin,GK,ua Ukraine,22-347,2001,2.0,0,0,0,0,0,0,0,,0,0,0,0,0,0,1,0,Matches
455,439,Heorhii Tsitaishvili,"DF,MF",ge Georgia,23-238,2000,2.1,5,4,5,0,0,3,3,100.0,0,0,0,0,0,5,3,1,Matches
456,440,Viktor Tsyhankov,FW,ua Ukraine,26-241,1997,0.7,0,0,0,0,0,0,1,0.0,1,1,0,1,0,0,1,0,Matches
457,441,Ľubomír Tupta,MF,sk Slovakia,26-108,1998,0.1,0,0,0,0,0,0,0,,0,0,0,0,0,0,0,0,Matches
458,442,Oleksandr Tymchyk,DF,ua Ukraine,27-175,1997,2.2,10,4,5,5,0,6,12,50.0,6,2,0,2,3,13,6,0,Matches
459,443,Deniz Undav,MF,de Germany,27-360,1996,0.1,1,1,0,0,1,1,1,100.0,0,0,0,0,0,1,0,0,Matches
460,444,Dayot Upamecano,DF,fr France,25-260,1998,6.3,9,7,6,3,0,5,6,83.3,1,3,1,2,6,15,24,0,Matches
461,445,Kacper Urbanski,"FW,MF",pl Poland,19-310,2004,1.6,2,1,2,0,0,1,3,33.3,2,2,0,2,1,3,2,0,Matches
462,446,Virgil van Dijk,DF,nl Netherlands,33-005,1991,6.0,4,2,4,0,0,1,1,100.0,0,5,4,1,2,6,36,1,Matches
463,447,Vladyslav Vanat,FW,ua Ukraine,22-191,2002,0.2,0,0,0,0,0,0,0,,0,0,0,0,0,0,0,0,Matches
464,448,Barnabás Varga,FW,hu Hungary,30-170,1994,2.8,4,1,1,2,1,2,2,100.0,0,5,1,4,1,5,7,0,Matches
465,449,Ruben Vargas,"MF,FW",ch Switzerland,25-343,1998,3.4,6,5,3,2,1,2,4,50.0,2,5,0,5,2,8,4,1,Matches
466,450,Denis Vavro,DF,sk Slovakia,28-094,1996,4.3,2,1,2,0,0,2,4,50.0,2,6,5,1,2,4,18,0,Matches
468,451,Joey Veerman,MF,nl Netherlands,25-237,1998,2.3,3,1,1,1,1,3,7,42.9,4,4,1,3,1,4,1,0,Matches
469,452,Miloš Veljković,DF,rs Serbia,28-291,1995,3.0,2,0,2,0,0,2,2,100.0,0,0,0,0,0,2,6,0,Matches
470,453,Micky van de Ven,DF,nl Netherlands,23-085,2001,0.8,1,1,1,0,0,1,2,50.0,1,2,1,1,0,1,5,0,Matches
471,454,Benjamin Verbič,MF,si Slovenia,30-229,1993,0.8,3,2,1,2,0,1,3,33.3,2,0,0,0,1,4,2,0,Matches
472,455,Bart Verbruggen,GK,nl Netherlands,21-330,2002,6.0,1,1,1,0,0,0,0,,0,0,0,0,0,1,4,0,Matches
473,456,Jan Vertonghen,DF,be Belgium,37-080,1987,3.0,4,2,1,3,0,0,0,,0,2,1,1,0,4,10,0,Matches
474,457,Jannik Vestergaard,DF,dk Denmark,31-345,1992,4.0,3,3,3,0,0,3,3,100.0,0,3,2,1,4,7,12,0,Matches
475,458,Žan Vipotnik,FW,si Slovenia,22-117,2002,0.2,0,0,0,0,0,0,1,0.0,1,0,0,0,0,0,1,0,Matches
476,459,Vitinha,MF,pt Portugal,24-151,2000,4.0,3,3,0,2,1,1,3,33.3,2,3,1,2,2,5,3,0,Matches
477,460,Daniel Vivian,DF,es Spain,24-364,1999,1.4,2,2,2,0,0,2,3,66.7,1,1,1,0,1,3,10,0,Matches
478,461,Dušan Vlahović,"MF,FW",rs Serbia,24-167,2000,2.0,0,0,0,0,0,0,1,0.0,1,0,0,0,1,1,0,0,Matches
479,462,Stefan de Vrij,DF,nl Netherlands,32-159,1992,6.0,12,7,7,4,1,8,10,80.0,2,6,2,4,2,14,20,0,Matches
480,463,Kyle Walker,DF,eng England,34-046,1990,6.7,5,2,2,2,1,2,4,50.0,2,5,1,4,5,10,6,0,Matches
481,464,Ollie Watkins,FW,eng England,28-196,1995,0.4,0,0,0,0,0,0,0,,0,0,0,0,1,1,0,0,Matches
482,465,Wout Weghorst,FW,nl Netherlands,31-341,1992,1.5,2,1,1,1,0,1,1,100.0,0,2,1,1,0,2,2,0,Matches
483,466,Andreas Weimann,FW,at Austria,32-343,1991,0.0,0,0,0,0,0,0,0,,0,0,0,0,0,0,0,0,Matches
484,467,Silvan Widmer,DF,ch Switzerland,31-130,1993,3.3,2,1,1,1,0,1,1,100.0,0,3,1,2,2,4,11,0,Matches
485,468,Georginio Wijnaldum,MF,nl Netherlands,33-245,1990,0.8,0,0,0,0,0,0,0,,0,0,0,0,0,0,0,0,Matches
486,469,Nico Williams,FW,es Spain,22-001,2002,4.5,3,2,0,1,2,1,5,20.0,4,4,0,4,0,3,1,0,Matches
487,470,Patrick Wimmer,"FW,MF",at Austria,23-044,2001,1.5,2,2,0,2,0,1,5,20.0,4,4,0,4,0,2,1,0,Matches
488,471,Jonas Wind,FW,dk Denmark,25-157,1999,2.1,0,0,0,0,0,0,1,0.0,1,1,0,1,0,0,1,0,Matches
489,472,Florian Wirtz,"FW,MF",de Germany,21-071,2003,3.1,3,3,0,2,1,1,3,33.3,2,3,0,3,1,4,1,0,Matches
490,473,Maximilian Wöber,DF,at Austria,26-160,1998,1.9,4,3,2,2,0,2,3,66.7,1,3,2,1,4,8,6,0,Matches
491,474,Granit Xhaka,MF,ch Switzerland,31-290,1992,5.3,8,5,3,4,1,4,6,66.7,2,5,4,1,1,9,15,0,Matches
492,475,Lamine Yamal,FW,es Spain,17-000,2007,4.6,10,6,5,4,1,4,8,50.0,4,5,0,5,3,13,1,0,Matches
494,476,Roman Yaremchuk,FW,ua Ukraine,28-229,1995,1.3,0,0,0,0,0,0,2,0.0,2,1,1,0,0,0,1,0,Matches
495,477,Andriy Yarmolenko,"FW,MF",ua Ukraine,34-264,1989,1.2,2,2,0,1,1,1,3,33.3,2,1,0,1,1,3,0,0,Matches
496,478,Yusuf Yazıcı,"MF,FW",tr Türkiye,27-166,1997,0.6,1,1,0,0,1,1,3,33.3,2,0,0,0,0,1,0,0,Matches
497,479,Kenan Yıldız,"FW,MF",tr Türkiye,19-070,2005,3.8,3,2,2,1,0,2,2,100.0,0,4,0,4,0,3,2,0,Matches
498,480,Okay Yokuşlu,"MF,DF",tr Türkiye,30-126,1994,0.6,2,1,1,1,0,0,1,0.0,1,2,0,2,2,4,4,0,Matches
499,481,İsmail Yüksek,MF,tr Türkiye,25-169,1999,1.7,6,2,2,3,1,3,5,60.0,2,2,1,1,1,7,4,0,Matches
500,482,Illia Zabarnyi,DF,ua Ukraine,21-316,2002,3.0,4,3,4,0,0,1,2,50.0,1,2,2,0,1,5,7,0,Matches
501,483,Mattia Zaccagni,"MF,FW",it Italy,29-027,1995,0.9,1,0,0,1,0,0,1,0.0,1,1,0,1,1,2,0,0,Matches
502,484,Denis Zakaria,MF,ch Switzerland,27-236,1996,0.3,0,0,0,0,0,0,0,,0,1,0,1,0,0,1,0,Matches
503,485,Nicola Zalewski,DF,pl Poland,22-172,2002,2.7,3,1,2,1,0,1,5,20.0,4,2,1,1,2,5,4,0,Matches
504,486,Piotr Zieliński,MF,pl Poland,30-054,1994,2.8,0,0,0,0,0,0,2,0.0,2,4,0,4,2,2,3,0,Matches
505,487,Oleksandr Zinchenko,DF,ua Ukraine,27-211,1996,2.4,6,5,4,1,1,4,8,50.0,4,4,1,3,1,7,4,0,Matches
506,488,Joshua Zirkzee,"FW,DF",nl Netherlands,23-052,2001,0.1,1,1,1,0,0,0,0,,0,0,0,0,0,1,0,0,Matches
507,489,Andrija Živković,DF,rs Serbia,28-002,1996,2.7,2,2,2,0,0,1,2,50.0,1,3,0,3,0,2,5,0,Matches
508,490,Budu Zivzivadze,"FW,MF",ge Georgia,30-125,1994,0.2,0,0,0,0,0,0,0,,0,0,0,0,0,0,0,0,Matches
509,491,Steven Zuber,MF,ch Switzerland,32-331,1991,0.9,0,0,0,0,0,0,1,0.0,1,0,0,0,0,0,0,0,Matches
510,492,Martín Zubimendi,MF,es Spain,25-162,1999,1.1,5,3,2,2,1,2,4,50.0,2,1,1,0,0,5,0,0,Matches
511,493,Oleksandr Zubkov,FW,ua Ukraine,27-345,1996,0.3,1,0,1,0,0,0,3,0.0,3,1,0,1,0,1,1,0,Matches
