,Rk,Player,Pos,Squad,Age,Born,90s,Tkl,TklW,Def 3rd,Mid 3rd,Att 3rd,Tkl.1,Att,Tkl%,Lost,Blocks,Sh,Pass,Int,Tkl+Int,Clr,Err,Matches
0,1,Che Adams,FW,sct Scotland,27-365,1996,2.3,2,1,1,1,0,1,1,100.0,0,2,0,2,1,3,0,0,Matches
1,2,Michel Aebischer,DF,ch Switzerland,27-188,1997,5.3,4,3,2,2,0,1,11,9.1,10,3,1,2,2,6,7,0,Matches
2,3,Arlind Ajeti,DF,al Albania,30-291,1993,3.0,1,0,0,1,0,1,3,33.3,2,5,4,1,6,7,13,0,Matches
3,4,Manuel Akanji,DF,ch Switzerland,28-359,1995,5.3,2,2,2,0,0,1,2,50.0,1,6,6,0,4,6,22,0,Matches
4,5,Samet Akaydın,DF,tr Türkiye,30-121,1994,3.7,8,4,8,0,0,6,8,75.0,2,5,5,0,7,15,16,0,Matches
5,6,Nathan Aké,DF,nl Netherlands,29-145,1995,5.2,7,5,7,0,0,4,7,57.1,3,4,3,1,6,13,14,0,Matches
6,7,Yunus Akgün,FW,tr Türkiye,24-005,2000,0.8,2,1,1,1,0,2,2,100.0,0,1,0,1,0,2,0,0,Matches
7,8,Kerem Aktürkoğlu,"FW,MF",tr Türkiye,25-265,1998,1.2,1,1,1,0,0,1,2,50.0,1,1,0,1,1,2,3,0,Matches
8,9,Trent Alexander-Arnold,"MF,DF",eng England,25-279,1998,1.5,1,0,1,0,0,0,1,0.0,1,4,2,2,2,3,3,1,Matches
9,10,Denis Alibec,FW,ro Romania,33-189,1991,0.3,0,0,0,0,0,0,0,,0,0,0,0,0,0,0,0,Matches
10,11,Barış Alper Yılmaz,FW,tr Türkiye,24-050,2000,5.0,5,0,0,3,2,1,3,33.3,2,1,0,1,0,5,1,0,Matches
11,12,Sandro Altunashvili,MF,ge Georgia,27-054,1997,0.6,0,0,0,0,0,0,0,,0,0,0,0,0,0,3,1,Matches
12,13,Zeki Amdouni,"MF,FW",ch Switzerland,23-221,2000,0.6,0,0,0,0,0,0,2,0.0,2,0,0,0,0,0,1,0,Matches
13,14,Joachim Andersen,DF,dk Denmark,28-042,1996,4.0,5,1,2,3,0,3,3,100.0,0,4,1,3,2,7,11,0,Matches
14,15,Robert Andrich,MF,de Germany,29-294,1994,3.5,12,8,8,4,0,5,7,71.4,2,3,1,2,2,14,12,0,Matches
15,16,Waldemar Anton,DF,de Germany,27-358,1996,0.4,0,0,0,0,0,0,0,,0,0,0,0,0,0,2,0,Matches
16,17,Stuart Armstrong,MF,sct Scotland,32-104,1992,0.2,1,0,1,0,0,0,0,,0,0,0,0,0,1,0,0,Matches
17,18,Marko Arnautović,FW,at Austria,35-084,1989,3.1,2,1,0,1,1,1,1,100.0,0,1,0,1,0,2,2,0,Matches
18,19,Jasir Asani,FW,al Albania,29-054,1995,2.3,3,1,3,0,0,1,7,14.3,6,1,0,1,4,7,4,0,Matches
19,20,Kristjan Asllani,MF,al Albania,22-125,2002,3.0,1,1,1,0,0,0,2,0.0,2,0,0,0,3,4,6,0,Matches
20,21,Kaan Ayhan,"MF,DF",tr Türkiye,29-245,1994,4.0,6,3,3,2,1,4,10,40.0,6,5,0,5,2,8,17,0,Matches
21,22,Alex Baena,"MF,FW",es Spain,22-358,2001,0.3,1,1,1,0,0,1,3,33.3,2,0,0,0,0,1,0,0,Matches
22,23,Alexander Bah,"DF,MF",dk Denmark,26-216,1997,3.1,4,4,2,1,1,4,8,50.0,4,1,0,1,5,9,5,0,Matches
23,24,Nedim Bajrami,"FW,MF",al Albania,25-135,1999,2.7,3,1,2,1,0,0,2,0.0,2,1,0,1,0,3,1,0,Matches
24,25,Johan Bakayoko,"FW,DF",be Belgium,21-083,2003,0.5,2,1,1,1,0,0,3,0.0,3,0,0,0,0,2,0,0,Matches
26,26,Jure Balkovec,DF,si Slovenia,29-307,1994,1.3,6,3,2,3,1,2,5,40.0,3,2,0,2,2,8,8,0,Matches
27,27,Iván Balliu,DF,al Albania,32-193,1992,1.0,0,0,0,0,0,0,0,,0,1,1,0,2,2,2,0,Matches
28,28,Nicușor Bancu,DF,ro Romania,31-298,1992,3.0,2,2,2,0,0,1,1,100.0,0,6,2,4,0,2,11,0,Matches
29,29,Antonín Barák,MF,cz Czechia,29-222,1994,0.5,1,1,0,0,1,0,1,0.0,1,0,0,0,0,1,0,0,Matches
30,30,Bradley Barcola,"FW,MF",fr France,21-314,2002,1.1,4,4,1,1,2,1,4,25.0,3,6,0,6,0,4,0,0,Matches
31,31,Abdülkerim Bardakcı,DF,tr Türkiye,29-309,1994,4.0,4,2,4,0,0,3,6,50.0,3,5,3,2,2,6,20,0,Matches
32,32,Nicolò Barella,MF,it Italy,27-156,1997,3.7,10,5,3,7,0,5,8,62.5,3,3,0,3,3,13,2,1,Matches
33,33,Alessandro Bastoni,DF,it Italy,25-090,1999,4.0,5,2,2,3,0,2,3,66.7,1,4,2,2,1,6,17,0,Matches
34,34,Martin Baturina,FW,hr Croatia,21-147,2003,0.1,1,1,0,1,0,0,0,,0,0,0,0,0,1,0,0,Matches
35,35,Christoph Baumgartner,"MF,FW",at Austria,24-346,1999,3.2,4,1,2,1,1,1,2,50.0,1,1,0,1,1,5,3,0,Matches
36,36,Altay Bayındır,GK,tr Türkiye,26-089,1998,1.0,0,0,0,0,0,0,0,,0,0,0,0,0,0,0,0,Matches
37,37,Jan Bednarek,DF,pl Poland,28-091,1996,3.0,2,1,2,0,0,2,6,33.3,4,8,7,1,3,5,13,0,Matches
38,38,Maximilian Beier,FW,de Germany,21-269,2002,0.3,0,0,0,0,0,0,0,,0,0,0,0,0,0,0,0,Matches
39,39,Jude Bellingham,MF,eng England,21-013,2003,6.4,9,6,1,4,4,1,5,20.0,4,5,1,4,3,12,4,1,Matches
40,40,László Bénes,MF,sk Slovakia,26-307,1997,0.8,1,1,0,0,1,1,1,100.0,0,0,0,0,0,1,1,0,Matches
41,41,Bartosz Bereszyński,DF,pl Poland,32-000,1992,0.1,0,0,0,0,0,0,0,,0,0,0,0,0,0,0,0,Matches
42,42,Steven Bergwijn,FW,nl Netherlands,26-278,1997,1.0,0,0,0,0,0,0,1,0.0,1,1,0,1,0,0,1,0,Matches
43,43,Medon Berisha,MF,al Albania,20-265,2003,0.2,0,0,0,0,0,0,0,,0,0,0,0,1,1,0,0,Matches
44,44,Victor Bernth Kristiansen,"DF,MF",dk Denmark,21-209,2002,1.7,4,3,3,1,0,1,2,50.0,1,2,0,2,0,4,4,1,Matches
45,45,Matúš Bero,"MF,DF",sk Slovakia,28-310,1995,0.5,1,1,0,1,0,0,0,,0,0,0,0,1,2,0,0,Matches
46,46,Jaka Bijol,DF,si Slovenia,25-158,1999,4.3,11,6,10,1,0,5,6,83.3,1,10,7,3,6,17,38,0,Matches
47,47,Veljko Birmančević,DF,rs Serbia,26-129,1998,0.3,0,0,0,0,0,0,0,,0,0,0,0,2,2,0,0,Matches
48,48,Daley Blind,FW,nl Netherlands,34-125,1990,0.0,0,0,0,0,0,0,0,,0,0,0,0,0,0,0,0,Matches
49,49,Bendegúz Bolla,DF,hu Hungary,24-233,1999,2.3,4,3,3,0,1,2,4,50.0,2,3,1,2,1,5,9,0,Matches
50,50,Endre Botka,DF,hu Hungary,29-322,1994,1.0,3,1,2,1,0,1,1,100.0,0,0,0,0,1,4,3,0,Matches
52,51,Jarrod Bowen,FW,eng England,27-205,1996,0.4,1,1,0,1,0,0,1,0.0,1,1,0,1,1,2,1,0,Matches
53,52,Róbert Boženík,FW,sk Slovakia,24-237,1999,2.3,3,3,0,3,0,0,1,0.0,1,1,0,1,0,3,3,0,Matches
54,53,Volodymyr Brazhko,MF,ua Ukraine,22-171,2002,2.0,8,5,5,3,0,1,1,100.0,0,2,1,1,5,13,4,0,Matches
55,54,David Brekalo,MF,si Slovenia,25-222,1998,0.0,0,0,0,0,0,0,0,,0,0,0,0,0,0,2,0,Matches
56,55,Brian Brobbey,FW,nl Netherlands,22-162,2002,0.0,0,0,0,0,0,0,0,,0,0,0,0,0,0,0,0,Matches
57,56,Armando Broja,FW,al Albania,22-306,2001,1.2,1,1,0,0,1,0,0,,0,0,0,0,0,1,1,0,Matches
58,57,Marcelo Brozović,MF,hr Croatia,31-239,1992,2.5,1,0,1,0,0,0,2,0.0,2,3,1,2,4,5,4,0,Matches
59,58,Jacob Bruun Larsen,FW,dk Denmark,25-297,1998,0.1,0,0,0,0,0,0,0,,0,0,0,0,0,0,0,0,Matches
60,59,Ante Budimir,FW,hr Croatia,32-356,1991,1.4,2,2,0,1,1,1,1,100.0,0,3,1,2,0,2,2,0,Matches
61,60,Adam Buksa,FW,pl Poland,28-000,1996,1.7,0,0,0,0,0,0,0,,0,4,0,4,0,0,3,0,Matches
62,61,Andrei Burcă,DF,ro Romania,31-088,1993,4.0,4,2,3,1,0,3,4,75.0,1,7,4,3,1,5,23,0,Matches
63,62,Riccardo Calafiori,DF,it Italy,22-054,2002,3.0,3,1,3,0,0,2,6,33.3,4,2,1,1,6,9,9,0,Matches
64,63,Hakan Çalhanoğlu,MF,tr Türkiye,30-155,1994,3.9,5,4,3,2,0,3,6,50.0,3,3,1,2,1,6,6,0,Matches
65,64,Eduardo Camavinga,MF,fr France,21-245,2002,1.9,5,2,3,1,1,2,5,40.0,3,9,1,8,1,6,5,0,Matches
66,65,Andrea Cambiaso,"FW,DF",it Italy,24-143,2000,0.8,4,4,4,0,0,3,4,75.0,1,1,1,0,0,4,0,0,Matches
67,66,Emre Can,MF,de Germany,30-182,1994,1.1,4,3,2,2,0,2,2,100.0,0,2,2,0,1,5,2,0,Matches
68,67,João Cancelo,"DF,MF",pt Portugal,30-046,1994,3.8,6,4,2,2,2,4,8,50.0,4,2,0,2,4,10,8,1,Matches
69,68,Yannick Carrasco,"DF,FW",be Belgium,30-312,1993,2.4,4,2,0,4,0,3,7,42.9,4,0,0,0,0,4,3,0,Matches
70,69,Dani Carvajal,DF,es Spain,32-183,1992,4.2,5,2,3,0,2,2,6,33.3,4,5,2,3,6,11,5,0,Matches
71,70,Timothy Castagne,DF,be Belgium,28-220,1995,4.0,1,1,0,1,0,0,2,0.0,2,5,2,3,2,3,14,0,Matches
72,71,Koen Casteels,GK,be Belgium,32-017,1992,4.0,0,0,0,0,0,0,0,,0,0,0,0,0,0,2,0,Matches
73,72,Žan Celar,"FW,MF",si Slovenia,25-120,1999,0.7,1,1,0,1,0,1,1,100.0,0,0,0,0,1,2,2,0,Matches
74,73,Zeki Çelik,"DF,MF",tr Türkiye,27-146,1997,1.2,3,0,2,1,0,3,4,75.0,1,1,0,1,0,3,0,0,Matches
75,74,Václav Černý,MF,cz Czechia,26-269,1997,0.6,1,1,1,0,0,1,3,33.3,2,1,0,1,0,1,1,0,Matches
76,75,Giorgi Chakvetadze,"MF,FW",ge Georgia,24-318,1999,2.7,10,5,7,2,1,6,9,66.7,3,7,2,5,1,11,3,0,Matches
78,76,Federico Chiesa,"FW,MF",it Italy,26-261,1997,2.9,6,4,4,1,1,3,5,60.0,2,0,0,0,3,9,2,0,Matches
79,77,Tomáš Chorý,MF,cz Czechia,29-168,1995,0.4,0,0,0,0,0,0,0,,0,0,0,0,0,0,0,0,Matches
80,78,Andreas Christensen,DF,dk Denmark,28-093,1996,3.9,4,2,4,0,0,3,3,100.0,0,3,1,2,6,10,11,0,Matches
81,79,Ryan Christie,"MF,FW",sct Scotland,29-141,1995,1.1,0,0,0,0,0,0,0,,0,0,0,0,0,0,1,0,Matches
82,80,Mojmir Chytil,FW,cz Czechia,25-074,1999,1.2,0,0,0,0,0,0,0,,0,2,0,2,0,0,2,0,Matches
83,81,Alexandru Cicâldău,MF,ro Romania,27-004,1997,0.2,2,0,2,0,0,1,1,100.0,0,1,0,1,0,2,0,0,Matches
84,82,Florinel Coman,MF,ro Romania,26-093,1998,1.3,1,1,1,0,0,0,0,,0,1,0,1,1,2,2,0,Matches
85,83,Kingsley Coman,MF,fr France,28-029,1996,0.2,0,0,0,0,0,0,0,,0,0,0,0,0,0,0,0,Matches
86,84,Francisco Conceição,"FW,MF",pt Portugal,21-211,2002,2.0,2,1,0,2,0,0,3,0.0,3,1,0,1,0,2,0,0,Matches
87,85,Diogo Costa,GK,pt Portugal,24-297,1999,5.7,0,0,0,0,0,0,0,,0,0,0,0,0,0,2,0,Matches
88,86,Vladimír Coufal,"DF,FW",cz Czechia,31-325,1992,3.0,5,4,4,1,0,4,9,44.4,5,7,6,1,2,7,13,0,Matches
89,87,Bryan Cristante,MF,it Italy,29-131,1995,1.5,0,0,0,0,0,0,0,,0,1,1,0,2,2,1,0,Matches
90,88,Kevin Csoboth,DF,hu Hungary,24-022,2000,0.1,0,0,0,0,0,0,1,0.0,1,1,0,1,0,0,0,0,Matches
91,89,Marc Cucurella,DF,es Spain,25-356,1998,5.1,12,9,3,6,3,5,8,62.5,3,9,4,5,6,18,10,0,Matches
92,90,Mirlind Daku,FW,al Albania,26-193,1998,0.1,1,0,0,0,1,0,0,,0,0,0,0,0,1,0,0,Matches
93,91,Diogo Dalot,"DF,MF",pt Portugal,25-116,1999,1.7,1,1,1,0,0,0,0,,0,2,1,1,1,2,1,0,Matches
94,92,Mikkel Damsgaard,FW,dk Denmark,24-009,2000,0.4,1,1,1,0,0,0,0,,0,1,0,1,1,2,1,0,Matches
95,93,Kevin Danso,DF,at Austria,25-297,1998,2.4,0,0,0,0,0,0,1,0.0,1,4,3,1,0,0,13,0,Matches
96,94,Márton Dárdai,DF,hu Hungary,22-151,2002,1.9,4,1,4,0,0,2,5,40.0,3,2,0,2,0,4,3,0,Matches
97,95,Matteo Darmian,DF,it Italy,34-223,1989,1.8,1,1,1,0,0,1,2,50.0,1,4,3,1,1,2,6,0,Matches
98,96,Zuriko Davitashvili,"FW,MF",ge Georgia,23-148,2001,1.3,4,3,2,0,2,2,3,66.7,1,3,0,3,0,4,1,0,Matches
99,97,Paweł Dawidowicz,DF,pl Poland,29-053,1995,2.0,1,0,1,0,0,0,1,0.0,1,4,3,1,0,1,7,0,Matches
100,98,Kevin De Bruyne,MF,be Belgium,33-014,1991,4.0,5,1,3,0,2,1,3,33.3,2,2,0,2,0,5,2,0,Matches
101,99,Charles De Ketelaere,FW,be Belgium,23-124,2001,0.0,0,0,0,0,0,0,0,,0,0,0,0,0,0,0,0,Matches
102,100,Zeno Debast,DF,be Belgium,20-262,2003,1.2,3,1,2,1,0,1,1,100.0,0,3,1,2,0,3,8,0,Matches
104,101,Thomas Delaney,MF,dk Denmark,32-313,1991,0.9,0,0,0,0,0,0,0,,0,0,0,0,2,2,2,0,Matches
105,102,Ousmane Dembélé,"FW,MF",fr France,27-058,1997,4.0,8,5,0,5,3,3,3,100.0,0,7,0,7,1,9,2,1,Matches
106,103,Merih Demiral,DF,tr Türkiye,26-129,1998,2.3,2,2,2,0,0,2,2,100.0,0,8,6,2,4,6,26,1,Matches
107,104,Giovanni Di Lorenzo,"DF,FW",it Italy,30-343,1993,4.0,13,9,9,3,1,7,12,58.3,5,4,1,3,6,19,6,1,Matches
108,105,Rúben Dias,DF,pt Portugal,27-059,1997,4.7,2,1,2,0,0,1,3,33.3,2,7,4,3,3,5,12,0,Matches
109,106,Federico Dimarco,"DF,FW",it Italy,26-245,1997,2.5,4,2,0,2,2,2,2,100.0,0,4,2,2,2,6,2,1,Matches
110,107,Berat Djimsiti,DF,al Albania,31-144,1993,3.0,1,0,1,0,0,0,1,0.0,1,8,5,3,2,3,16,0,Matches
111,108,Jeremy Doku,"FW,MF",be Belgium,22-046,2002,3.6,3,2,3,0,0,1,4,25.0,3,1,0,1,1,4,1,1,Matches
112,109,Kasper Dolberg,FW,dk Denmark,26-280,1997,0.4,1,1,0,1,0,0,0,,0,0,0,0,0,1,0,0,Matches
113,110,Gianluigi Donnarumma,GK,it Italy,25-138,1999,4.0,0,0,0,0,0,0,0,,0,0,0,0,0,0,2,0,Matches
114,111,David Doudera,FW,cz Czechia,26-042,1998,1.0,3,2,3,0,0,3,4,75.0,1,1,0,1,0,3,2,0,Matches
115,112,Artem Dovbyk,FW,ua Ukraine,27-021,1997,2.7,2,2,0,0,2,0,0,,0,0,0,0,1,3,2,0,Matches
116,113,Denis Drăguș,FW,ro Romania,25-006,1999,3.2,2,1,1,0,1,0,5,0.0,5,4,1,3,1,3,8,0,Matches
117,114,Radu Drăgușin,DF,ro Romania,22-160,2002,4.0,1,1,1,0,0,1,3,33.3,2,6,4,2,6,7,33,0,Matches
118,115,Vanja Drkušič,DF,si Slovenia,24-256,1999,4.3,12,7,11,1,0,11,13,84.6,2,3,2,1,1,13,16,0,Matches
119,116,Kwadwo Duah,FW,ch Switzerland,27-139,1997,1.2,1,1,0,0,1,1,1,100.0,0,0,0,0,1,2,0,0,Matches
120,117,Martin Dúbravka,GK,sk Slovakia,35-179,1989,4.3,0,0,0,0,0,0,0,,0,1,0,1,1,1,3,1,Matches
121,118,Ondrej Duda,MF,sk Slovakia,29-220,1994,3.5,7,3,2,4,1,4,6,66.7,2,8,3,5,3,10,5,0,Matches
122,119,Denzel Dumfries,DF,nl Netherlands,28-085,1996,5.0,7,5,4,0,3,4,7,57.1,3,5,2,3,3,10,6,0,Matches
123,120,Dávid Ďuriš,"FW,MF",sk Slovakia,25-112,1999,0.3,0,0,0,0,0,0,0,,0,0,0,0,0,0,0,0,Matches
124,121,Lasha Dvali,DF,ge Georgia,29-059,1995,4.0,8,3,7,1,0,4,7,57.1,3,6,5,1,1,9,24,0,Matches
125,122,Timi Elšnik,MF,si Slovenia,26-074,1998,4.0,13,7,7,4,2,5,7,71.4,2,6,3,3,4,17,5,0,Matches
126,123,Breel Embolo,FW,ch Switzerland,27-149,1997,3.3,3,3,0,2,1,0,0,,0,3,0,3,1,4,3,0,Matches
127,124,Christian Eriksen,"MF,FW",dk Denmark,32-149,1992,3.9,6,2,1,3,2,3,4,75.0,1,3,0,3,2,8,2,0,Matches
128,125,Eberechi Eze,"DF,MF",eng England,26-013,1998,1.1,0,0,0,0,0,0,0,,0,0,0,0,0,0,3,0,Matches
130,126,Wout Faes,DF,be Belgium,26-100,1998,4.0,10,7,5,5,0,3,3,100.0,0,5,3,2,4,14,11,2,Matches
131,127,Nicolò Fagioli,MF,it Italy,23-151,2001,1.1,3,1,2,0,1,1,2,50.0,1,1,1,0,0,3,0,0,Matches
132,128,João Félix,"MF,FW",pt Portugal,24-245,1999,1.2,0,0,0,0,0,0,4,0.0,4,0,0,0,0,0,0,0,Matches
133,129,Bruno Fernandes,MF,pt Portugal,29-308,1994,4.2,8,5,5,3,0,2,3,66.7,1,6,1,5,2,10,2,0,Matches
134,130,Attila Fiola,DF,hu Hungary,34-146,1990,2.0,3,1,2,0,1,2,2,100.0,0,1,1,0,0,3,9,0,Matches
135,131,Phil Foden,"FW,MF",eng England,24-045,2000,5.9,5,3,2,2,1,1,4,25.0,3,5,0,5,1,6,2,0,Matches
136,132,Youssouf Fofana,MF,fr France,25-184,1999,0.5,1,1,1,0,0,0,3,0.0,3,0,0,0,1,2,1,0,Matches
137,133,Michael Folorunsho,FW,it Italy,26-156,1998,0.0,0,0,0,0,0,0,0,,0,0,0,0,0,0,0,0,Matches
138,134,Przemysław Frankowski,DF,pl Poland,29-091,1995,3.0,7,5,6,0,1,3,12,25.0,9,1,0,1,1,8,12,0,Matches
139,135,Davide Frattesi,MF,it Italy,24-264,1999,2.1,2,1,1,1,0,1,2,50.0,1,0,0,0,0,2,1,0,Matches
140,136,Remo Freuler,MF,ch Switzerland,32-088,1992,5.1,8,5,3,3,2,1,7,14.3,6,8,0,8,4,12,10,0,Matches
141,137,Jeremie Frimpong,FW,nl Netherlands,23-215,2000,1.0,0,0,0,0,0,0,1,0.0,1,0,0,0,0,0,1,0,Matches
142,138,Chris Führich,FW,de Germany,26-185,1998,0.2,1,1,0,0,1,1,1,100.0,0,2,0,2,0,1,0,0,Matches
143,139,Niclas Füllkrug,FW,de Germany,31-154,1993,1.8,1,0,0,0,1,1,1,100.0,0,0,0,0,0,1,3,0,Matches
144,140,Mijat Gaćinović,DF,rs Serbia,29-155,1995,0.5,1,1,1,0,0,1,2,50.0,1,2,0,2,0,1,0,0,Matches
145,141,Cody Gakpo,FW,nl Netherlands,25-066,1999,5.8,9,8,3,4,2,2,12,16.7,10,5,0,5,4,13,5,0,Matches
146,142,Conor Gallagher,MF,eng England,24-157,2000,1.3,1,0,1,0,0,0,2,0.0,2,3,1,2,1,2,4,1,Matches
147,143,Dániel Gazdag,MF,hu Hungary,28-132,1996,0.0,1,1,1,0,0,0,0,,0,0,0,0,0,1,0,0,Matches
148,144,Lutsharel Geertruida,DF,nl Netherlands,23-360,2000,1.2,4,3,3,1,0,0,0,,0,2,0,2,0,4,0,0,Matches
149,145,Billy Gilmour,MF,sct Scotland,23-031,2001,2.0,1,1,0,1,0,0,0,,0,2,0,2,0,1,2,0,Matches
150,146,Olivier Giroud,FW,fr France,37-286,1986,0.7,1,0,0,0,1,0,0,,0,0,0,0,0,1,1,0,Matches
151,147,Klaus Gjasula,MF,al Albania,34-211,1989,0.2,0,0,0,0,0,0,2,0.0,2,1,0,1,0,0,0,0,Matches
152,148,Adam Gnezda Čerin,MF,si Slovenia,24-362,1999,4.3,9,5,8,1,0,4,9,44.4,5,7,0,7,5,14,10,0,Matches
153,149,Anthony Gordon,FW,eng England,23-139,2001,0.0,0,0,0,0,0,0,0,,0,0,0,0,0,0,0,0,Matches
154,150,Jon Gorenc Stanković,MF,si Slovenia,28-180,1996,1.0,1,1,1,0,0,0,1,0.0,1,3,3,0,0,1,2,0,Matches
156,151,Michael Gregoritsch,FW,at Austria,30-085,1994,1.4,1,1,0,1,0,1,2,50.0,1,1,0,1,0,1,0,0,Matches
157,152,Antoine Griezmann,"MF,FW",fr France,33-113,1991,4.4,5,3,2,2,1,4,6,66.7,2,4,0,4,1,6,2,1,Matches
158,153,Florian Grillitsch,MF,at Austria,28-340,1995,2.2,2,1,1,0,1,1,3,33.3,2,0,0,0,6,8,0,0,Matches
159,154,Álex Grimaldo,DF,es Spain,28-296,1995,1.3,1,1,1,0,0,1,2,50.0,1,1,0,1,3,4,4,0,Matches
160,155,Pascal Groß,MF,de Germany,33-027,1991,0.5,1,1,0,1,0,0,0,,0,0,0,0,0,1,0,0,Matches
161,156,Kamil Grosicki,MF,pl Poland,36-034,1988,0.2,0,0,0,0,0,0,0,,0,1,0,1,0,0,0,0,Matches
162,157,Nemanja Gudelj,MF,rs Serbia,32-239,1991,1.0,1,0,1,0,0,1,1,100.0,0,0,0,0,1,2,1,0,Matches
163,158,Marc Guéhi,DF,eng England,23-365,2000,5.3,2,2,0,1,1,0,1,0.0,1,8,5,3,2,4,8,0,Matches
164,159,Péter Gulácsi,GK,hu Hungary,34-067,1990,3.0,0,0,0,0,0,0,1,0.0,1,0,0,0,0,0,3,0,Matches
165,160,Arda Güler,"FW,MF",tr Türkiye,19-138,2005,3.8,9,5,5,2,2,7,11,63.6,4,0,0,0,3,12,0,0,Matches
166,161,İlkay Gündoğan,MF,de Germany,33-262,1990,4.3,5,4,1,3,1,0,2,0.0,2,0,0,0,1,6,0,0,Matches
167,162,Angus Gunn,GK,sct Scotland,28-172,1996,3.0,0,0,0,0,0,0,0,,0,0,0,0,0,0,4,0,Matches
168,163,Mert Günok,GK,tr Türkiye,35-133,1989,4.0,0,0,0,0,0,0,0,,0,0,0,0,0,0,1,2,Matches
169,164,Joško Gvardiol,DF,hr Croatia,22-171,2002,3.0,5,3,3,1,1,2,4,50.0,2,2,1,1,5,10,4,0,Matches
170,165,Giorgi Gwelesiani,DF,ge Georgia,33-068,1991,1.8,3,3,3,0,0,3,5,60.0,2,3,3,0,2,5,15,1,Matches
171,166,Norbert Gyömbér,DF,sk Slovakia,32-009,1992,0.4,0,0,0,0,0,0,0,,0,0,0,0,1,1,2,0,Matches
172,167,Ianis Hagi,MF,ro Romania,25-264,1998,2.1,5,3,2,1,2,2,4,50.0,2,1,0,1,0,5,4,0,Matches
173,168,Dávid Hancko,DF,sk Slovakia,26-212,1997,4.1,10,5,6,4,0,4,11,36.4,7,7,2,5,3,13,10,0,Matches
174,169,Grant Hanley,DF,sct Scotland,32-235,1991,2.5,2,0,1,1,0,0,0,,0,2,1,1,1,3,11,0,Matches
175,170,Lukáš Haraslín,FW,sk Slovakia,28-047,1996,2.9,4,4,2,1,1,4,6,66.7,2,1,0,1,3,7,5,0,Matches
176,171,Kai Havertz,"FW,MF",de Germany,25-031,1999,4.3,2,1,1,1,0,2,2,100.0,0,4,0,4,0,2,8,0,Matches
177,172,Jack Hendry,DF,sct Scotland,29-066,1995,2.9,2,1,1,1,0,2,2,100.0,0,2,2,0,1,3,10,0,Matches
178,173,Benjamin Henrichs,DF,de Germany,27-140,1997,0.1,0,0,0,0,0,0,0,,0,0,0,0,0,0,0,0,Matches
179,174,Theo Hernández,DF,fr France,26-280,1997,6.3,10,6,7,2,1,6,9,66.7,3,6,5,1,3,13,12,2,Matches
180,175,Morten Hjulmand,MF,dk Denmark,25-017,1999,2.7,3,1,1,2,0,2,5,40.0,3,3,1,2,1,4,3,1,Matches
182,176,Adam Hložek,MF,cz Czechia,21-353,2002,1.2,1,0,0,0,1,0,1,0.0,1,0,0,0,1,2,1,0,Matches
183,177,Tomáš Holeš,DF,cz Czechia,31-103,1993,3.0,10,5,5,3,2,7,10,70.0,3,4,2,2,2,12,12,0,Matches
184,178,Arbër Hoxha,"FW,MF",al Albania,25-280,1998,0.6,2,2,1,1,0,2,2,100.0,0,0,0,0,0,2,0,0,Matches
185,179,Robin Hranáč,DF,cz Czechia,24-165,2000,3.0,2,1,1,1,0,2,2,100.0,0,3,1,2,0,2,12,1,Matches
186,180,Elseid Hysaj,DF,al Albania,30-143,1994,2.0,1,1,0,1,0,1,5,20.0,4,3,2,1,0,1,2,0,Matches
187,181,Pierre Højbjerg,MF,dk Denmark,28-342,1995,3.9,10,7,5,5,0,7,13,53.8,6,5,0,5,3,13,5,0,Matches
188,182,Rasmus Højlund,FW,dk Denmark,21-159,2003,3.2,3,1,0,1,2,1,4,25.0,3,0,0,0,1,4,1,0,Matches
189,183,Ivan Ilić,MF,rs Serbia,23-117,2001,2.2,6,4,4,1,1,3,3,100.0,0,4,3,1,0,6,3,1,Matches
190,184,Josip Iličić,"FW,MF",si Slovenia,36-165,1988,0.3,2,1,1,0,1,1,1,100.0,0,0,0,0,0,2,0,0,Matches
191,185,Gonçalo Inácio,DF,pt Portugal,22-322,2001,1.3,2,2,1,1,0,2,5,40.0,3,6,0,6,1,3,5,0,Matches
192,186,Luka Ivanušec,MF,hr Croatia,25-229,1998,0.2,0,0,0,0,0,0,0,,0,0,0,0,0,0,1,0,Matches
193,187,Erik Janža,DF,si Slovenia,31-021,1993,3.0,4,4,3,1,0,1,5,20.0,4,1,1,0,2,6,8,0,Matches
194,188,Jorginho,MF,it Italy,32-205,1991,2.4,6,2,6,0,0,3,8,37.5,5,3,0,3,4,10,1,0,Matches
195,189,Joselu,FW,es Spain,34-107,1990,1.0,0,0,0,0,0,0,1,0.0,1,1,0,1,0,0,3,0,Matches
196,190,Diogo Jota,"FW,MF",pt Portugal,27-221,1996,1.1,3,2,0,2,1,0,0,,0,1,0,1,0,3,0,0,Matches
197,191,Luka Jović,"MF,FW",rs Serbia,26-202,1997,1.1,0,0,0,0,0,0,0,,0,0,0,0,0,0,1,0,Matches
198,192,Josip Juranović,DF,hr Croatia,28-331,1995,1.0,3,3,1,2,0,2,3,66.7,1,1,1,0,1,4,1,0,Matches
199,193,David Jurásek,DF,cz Czechia,23-340,2000,1.8,3,2,2,1,0,2,5,40.0,3,1,1,0,1,4,2,0,Matches
200,194,Matěj Jurásek,"DF,MF",cz Czechia,20-317,2003,0.5,2,1,0,1,1,2,4,50.0,2,0,0,0,0,2,1,0,Matches
201,195,Ferdi Kadioglu,"DF,MF",tr Türkiye,24-279,1999,5.0,18,12,9,7,2,10,13,76.9,3,5,1,4,7,25,10,0,Matches
202,196,İrfan Kahveci,FW,tr Türkiye,28-363,1995,0.1,0,0,0,0,0,0,0,,0,0,0,0,0,0,0,0,Matches
203,197,Otar Kakabadze,"DF,MF",ge Georgia,29-015,1995,4.0,12,8,10,1,1,10,18,55.6,8,3,1,2,4,16,8,0,Matches
204,198,Harry Kane,FW,eng England,30-350,1993,6.0,4,3,2,2,0,1,3,33.3,2,1,1,0,1,5,0,0,Matches
205,199,N'Golo Kanté,MF,fr France,33-105,1991,5.7,12,9,6,3,3,4,5,80.0,1,6,1,5,6,18,7,0,Matches
206,200,Žan Karničnik,DF,si Slovenia,29-298,1994,4.3,8,4,7,1,0,7,12,58.3,5,5,3,2,8,16,11,0,Matches
208,201,Guram Kashia,DF,ge Georgia,37-008,1987,4.0,7,4,5,2,0,4,4,100.0,0,13,12,1,1,8,31,1,Matches
209,202,Milos Kerkez,DF,hu Hungary,20-248,2003,2.6,4,2,3,1,0,3,5,60.0,2,0,0,0,0,4,7,1,Matches
210,203,Semih Kılıçsoy,FW,tr Türkiye,18-332,2005,0.0,0,0,0,0,0,0,0,,0,0,0,0,0,0,0,0,Matches
211,204,Joshua Kimmich,DF,de Germany,29-155,1995,5.3,7,4,5,0,2,4,12,33.3,8,6,2,4,6,13,6,0,Matches
212,205,Otar Kiteishvili,MF,ge Georgia,28-108,1996,1.4,4,4,4,0,0,2,6,33.3,4,3,1,2,0,4,3,0,Matches
213,206,Jakub Kiwior,DF,pl Poland,24-148,2000,3.0,7,4,6,1,0,3,5,60.0,2,4,2,2,5,12,9,0,Matches
214,207,László Kleinheisler,MF,hu Hungary,30-095,1994,0.6,0,0,0,0,0,0,1,0.0,1,0,0,0,0,0,0,0,Matches
215,208,Giorgi Kochorashvili,MF,ge Georgia,25-013,1999,4.0,9,5,5,4,0,5,6,83.3,1,6,4,2,5,14,6,1,Matches
216,209,Orkun Kökçü,MF,tr Türkiye,23-196,2000,2.5,3,2,2,0,1,1,4,25.0,3,3,1,2,1,4,2,0,Matches
217,210,Randal Kolo Muani,FW,fr France,25-220,1998,2.2,1,0,1,0,0,1,1,100.0,0,2,1,1,1,2,4,0,Matches
218,211,Yukhym Konoplia,DF,ua Ukraine,24-321,1999,0.8,1,0,0,0,1,0,0,,0,1,0,1,0,1,0,0,Matches
219,212,Ezri Konsa,DF,eng England,26-263,1997,1.0,2,0,2,0,0,1,1,100.0,0,3,2,1,0,2,8,0,Matches
220,213,Filip Kostić,DF,rs Serbia,31-254,1992,0.5,1,0,1,0,0,1,2,50.0,1,1,0,1,0,1,1,0,Matches
221,214,Jules Koundé,DF,fr France,25-243,1998,6.3,18,12,7,5,6,10,17,58.8,7,5,0,5,2,20,22,0,Matches
222,215,Mateo Kovačić,MF,hr Croatia,30-067,1994,2.5,8,6,2,5,1,2,5,40.0,3,2,1,1,3,11,0,0,Matches
223,216,Matej Kovar,GK,cz Czechia,24-056,2000,0.4,0,0,0,0,0,0,0,,0,0,0,0,0,0,0,0,Matches
224,217,Andrej Kramarić,FW,hr Croatia,33-023,1991,2.7,0,0,0,0,0,0,0,,0,3,1,2,1,1,1,0,Matches
225,218,Ladislav Krejčí,DF,cz Czechia,25-083,1999,3.0,3,2,3,0,0,0,3,0.0,3,1,1,0,5,8,9,0,Matches
226,219,Toni Kroos,MF,de Germany,34-190,1990,5.2,9,4,4,4,1,3,5,60.0,2,3,0,3,7,16,5,0,Matches
227,220,Jan Kuchta,FW,cz Czechia,27-186,1997,1.1,2,1,2,0,0,1,1,100.0,0,0,0,0,0,2,2,0,Matches
228,221,Juraj Kucka,MF,sk Slovakia,37-137,1987,3.9,1,1,0,1,0,1,7,14.3,6,3,1,2,2,3,4,0,Matches
229,222,Jasmin Kurtić,FW,si Slovenia,35-184,1989,0.0,0,0,0,0,0,0,0,,0,0,0,0,0,0,0,0,Matches
230,223,Khvicha Kvaratskhelia,FW,ge Georgia,23-151,2001,3.8,4,3,0,4,0,3,6,50.0,3,2,2,0,0,4,2,0,Matches
231,224,Nika Kvekveskiri,MF,ge Georgia,32-044,1992,0.1,0,0,0,0,0,0,1,0.0,1,0,0,0,1,1,0,0,Matches
232,225,Giorgi Kvilitaia,FW,ge Georgia,30-285,1993,0.0,0,0,0,0,0,0,0,,0,0,0,0,0,0,0,0,Matches
234,226,Solomon Kvirkvelia,DF,ge Georgia,32-157,1992,2.0,4,3,3,1,0,3,3,100.0,0,2,2,0,1,5,17,1,Matches
235,227,Qazim Laçi,"MF,FW",al Albania,28-175,1996,1.8,4,3,1,2,1,1,2,50.0,1,3,0,3,3,7,5,0,Matches
236,228,Konrad Laimer,"MF,FW",at Austria,27-046,1997,3.0,5,1,2,1,2,3,6,50.0,3,3,0,3,2,7,2,0,Matches
237,229,Ádám Lang,DF,hu Hungary,31-177,1993,0.5,0,0,0,0,0,0,0,,0,0,0,0,1,1,3,0,Matches
238,230,Aymeric Laporte,DF,es Spain,30-046,1994,4.8,3,3,2,1,0,2,3,66.7,1,4,3,1,5,8,21,1,Matches
239,231,Robin Le Normand,DF,es Spain,27-244,1996,4.0,6,2,5,1,0,5,8,62.5,3,2,1,1,2,8,11,0,Matches
240,232,Rafael Leão,FW,pt Portugal,25-032,1999,3.2,2,2,2,0,0,1,2,50.0,1,1,0,1,1,3,1,0,Matches
241,233,Robert Lewandowski,FW,pl Poland,35-326,1988,1.3,2,2,0,0,2,0,0,,0,2,0,2,0,2,3,0,Matches
242,234,Philipp Lienhart,DF,at Austria,28-001,1996,2.4,2,2,1,1,0,2,3,66.7,1,2,2,0,2,4,10,0,Matches
243,235,Ondřej Lingr,"MF,FW",cz Czechia,25-279,1998,0.9,2,2,0,2,0,0,1,0.0,1,1,0,1,0,2,0,0,Matches
244,236,Dominik Livaković,GK,hr Croatia,29-185,1995,3.0,0,0,0,0,0,0,0,,0,0,0,0,1,1,2,0,Matches
245,237,Stanislav Lobotka,MF,sk Slovakia,29-230,1994,4.3,7,6,3,4,0,2,6,33.3,4,3,0,3,3,10,9,0,Matches
246,238,Saba Lobzhanidze,FW,ge Georgia,29-207,1994,0.1,0,0,0,0,0,0,0,,0,0,0,0,0,0,3,0,Matches
247,239,Luka Lochoshvili,"DF,MF",ge Georgia,26-044,1998,1.9,4,3,3,0,1,3,5,60.0,2,1,0,1,3,7,11,0,Matches
248,240,Fermin López,MF,es Spain,21-062,2003,0.3,1,1,0,0,1,0,1,0.0,1,0,0,0,0,1,0,0,Matches
249,241,Romelu Lukaku,FW,be Belgium,31-060,1993,4.0,0,0,0,0,0,0,0,,0,0,0,0,0,0,3,0,Matches
250,242,Dodi Lukebakio,"FW,DF",be Belgium,26-292,1997,0.7,1,1,0,0,1,0,0,,0,1,0,1,0,1,0,0,Matches
251,243,Saša Lukić,MF,rs Serbia,27-334,1996,2.3,8,5,1,5,2,5,6,83.3,1,2,0,2,3,11,5,0,Matches
252,244,Andriy Lunin,GK,ua Ukraine,25-152,1999,1.0,0,0,0,0,0,0,0,,0,0,0,0,0,0,0,2,Matches
253,245,Mike Maignan,GK,fr France,29-009,1995,6.3,1,0,1,0,0,1,1,100.0,0,0,0,0,0,1,5,0,Matches
254,246,Kobbie Mainoo,MF,eng England,19-084,2005,3.3,6,4,1,4,1,3,4,75.0,1,0,0,0,6,12,1,0,Matches
255,247,Lovro Majer,"FW,MF",hr Croatia,26-177,1998,1.6,4,3,1,2,1,2,2,100.0,0,4,0,4,0,4,0,0,Matches
256,248,Donyell Malen,FW,nl Netherlands,25-185,1999,2.1,0,0,0,0,0,0,0,,0,0,0,0,2,2,2,0,Matches
257,249,Ruslan Malinovskyi,MF,ua Ukraine,31-069,1993,0.4,5,1,1,4,0,1,3,33.3,2,1,0,1,1,6,3,0,Matches
258,250,Giorgi Mamardashvili,GK,ge Georgia,23-287,2000,4.0,0,0,0,0,0,0,0,,0,0,0,0,0,0,2,0,Matches
260,251,Dennis Man,MF,ro Romania,25-321,1998,3.0,3,0,1,2,0,2,4,50.0,2,0,0,0,1,4,0,0,Matches
261,252,Rey Manaj,FW,al Albania,27-139,1997,1.7,2,2,1,0,1,0,1,0.0,1,0,0,0,1,3,2,0,Matches
262,253,Gianluca Mancini,DF,it Italy,28-086,1996,1.0,0,0,0,0,0,0,0,,0,3,1,2,0,0,1,0,Matches
263,254,Orel Mangala,MF,be Belgium,26-116,1998,1.5,4,3,2,1,1,1,3,33.3,2,2,1,1,4,8,0,0,Matches
264,255,Marius Marin,MF,ro Romania,25-317,1998,3.4,9,3,8,1,0,5,10,50.0,5,4,1,3,4,13,6,0,Matches
265,256,Răzvan Marin,MF,ro Romania,28-050,1996,3.9,7,2,3,4,0,4,9,44.4,5,3,2,1,0,7,6,0,Matches
266,257,Ádám Martin,"FW,DF",hu Hungary,29-249,1994,0.5,0,0,0,0,0,0,0,,0,2,2,0,0,0,0,0,Matches
267,258,Mykola Matviyenko,DF,ua Ukraine,28-071,1996,3.0,4,3,2,2,0,2,4,50.0,2,4,2,2,4,8,9,1,Matches
268,259,Kylian Mbappé,FW,fr France,25-205,1998,5.2,1,0,1,0,0,0,2,0.0,2,4,1,3,0,1,0,0,Matches
269,260,John McGinn,"MF,FW",sct Scotland,29-268,1994,2.6,1,1,0,1,0,1,4,25.0,3,2,0,2,1,2,0,0,Matches
270,261,Callum McGregor,MF,sct Scotland,31-028,1993,2.7,2,1,1,1,0,1,4,25.0,3,2,1,1,2,4,6,0,Matches
271,262,Scott McKenna,DF,sct Scotland,27-243,1996,1.5,1,0,1,0,0,1,2,50.0,1,1,1,0,2,3,5,0,Matches
272,263,Kenny McLean,MF,sct Scotland,32-186,1992,0.5,3,2,1,2,0,3,3,100.0,0,0,0,0,0,3,0,0,Matches
273,264,Scott McTominay,MF,sct Scotland,27-217,1996,3.0,4,2,2,1,1,1,2,50.0,1,2,1,1,3,7,7,0,Matches
274,265,Anzor Mekvabishvili,MF,ge Georgia,23-037,2001,2.1,6,3,3,3,0,3,3,100.0,0,4,1,3,5,11,5,0,Matches
275,266,Memphis,"FW,MF",nl Netherlands,30-150,1994,5.1,1,1,0,1,0,1,4,25.0,3,1,0,1,1,2,1,0,Matches
276,267,Nuno Mendes,DF,pt Portugal,22-023,2002,4.7,12,6,7,3,2,6,11,54.5,5,6,2,4,5,17,11,0,Matches
277,268,Mikel Merino,"MF,FW",es Spain,28-020,1996,2.0,4,3,0,3,1,2,3,66.7,1,2,1,1,2,6,4,0,Matches
278,269,Valentin Mihaila,MF,ro Romania,24-161,2000,1.3,3,2,2,0,1,0,1,0.0,1,0,0,0,2,5,5,0,Matches
279,270,Srđan Mijailović,DF,rs Serbia,30-245,1993,0.8,3,1,1,2,0,3,4,75.0,1,1,0,1,1,4,4,0,Matches
280,271,Georges Mikautadze,FW,ge Georgia,23-255,2000,3.8,3,1,1,2,0,1,4,25.0,3,0,0,0,0,3,0,0,Matches
281,272,Nikola Milenković,DF,rs Serbia,26-274,1997,3.0,3,3,1,2,0,1,2,50.0,1,2,2,0,2,5,11,0,Matches
282,273,Sergej Milinković-Savić,MF,rs Serbia,29-136,1995,1.3,2,2,0,2,0,1,2,50.0,1,1,1,0,1,3,2,0,Matches
283,274,Mario Mitaj,DF,al Albania,20-341,2003,3.0,8,4,6,1,1,8,11,72.7,3,4,0,4,7,15,11,0,Matches
284,275,Aleksandar Mitrović,FW,rs Serbia,29-300,1994,2.7,0,0,0,0,0,0,1,0.0,1,2,0,2,0,0,4,0,Matches
286,276,Maximilian Mittelstädt,DF,de Germany,27-116,1997,3.4,4,2,1,1,2,3,5,60.0,2,6,0,6,2,6,8,0,Matches
287,277,Filip Mladenović,DF,rs Serbia,32-332,1991,1.2,2,1,0,1,1,1,5,20.0,4,0,0,0,2,4,1,0,Matches
288,278,Jan Mlakar,MF,si Slovenia,25-263,1998,3.3,3,3,2,1,0,1,2,50.0,1,2,1,1,1,4,9,0,Matches
289,279,Jakub Moder,MF,pl Poland,25-096,1999,2.0,2,2,0,2,0,1,3,33.3,2,3,1,2,1,3,8,0,Matches
290,280,Luka Modrić,MF,hr Croatia,38-307,1985,2.6,4,4,4,0,0,1,2,50.0,1,1,0,1,1,5,1,0,Matches
291,281,Vasile Mogos,DF,ro Romania,31-255,1992,0.4,0,0,0,0,0,0,1,0.0,1,0,0,0,0,0,1,0,Matches
292,282,Álvaro Morata,FW,es Spain,31-263,1992,4.2,6,4,1,2,3,0,4,0.0,4,0,0,0,0,6,2,0,Matches
293,283,Lewis Morgan,DF,sct Scotland,27-286,1996,0.0,0,0,0,0,0,0,0,,0,0,0,0,1,1,0,0,Matches
294,284,Ernest Muçi,FW,al Albania,23-115,2001,0.2,0,0,0,0,0,0,0,,0,0,0,0,0,0,0,0,Matches
295,285,Mykhailo Mudryk,"FW,MF",ua Ukraine,23-189,2001,1.9,2,2,1,0,1,2,4,50.0,2,0,0,0,0,2,1,1,Matches
296,286,Mert Müldür,"DF,MF",tr Türkiye,25-100,1999,3.8,7,6,3,1,3,7,9,77.8,2,8,1,7,5,12,12,0,Matches
297,287,Thomas Müller,"MF,FW",de Germany,34-303,1989,0.6,2,1,1,1,0,1,2,50.0,1,0,0,0,0,2,1,0,Matches
298,288,Jamal Musiala,FW,de Germany,21-137,2003,4.7,6,4,1,4,1,2,3,66.7,1,7,0,7,4,10,2,0,Matches
299,289,Phillipp Mwene,DF,at Austria,30-165,1994,2.2,6,4,3,3,0,3,6,50.0,3,5,2,3,0,6,6,0,Matches
300,290,Vitaliy Mykolenko,DF,ua Ukraine,25-044,1999,0.6,0,0,0,0,0,0,0,,0,2,1,1,0,0,1,0,Matches
301,291,Joakim Mæhle,"DF,MF",dk Denmark,27-053,1997,3.1,6,4,3,2,1,3,8,37.5,5,2,0,2,3,9,5,1,Matches
302,292,Nacho,DF,es Spain,34-176,1990,2.8,2,1,1,1,0,1,3,33.3,2,3,2,1,0,2,15,0,Matches
303,293,Ádám Nagy,MF,hu Hungary,29-025,1995,1.8,3,2,2,1,0,2,2,100.0,0,1,0,1,4,7,3,0,Matches
304,294,Zsolt Nagy,DF,hu Hungary,31-048,1993,0.2,2,0,1,1,0,0,0,,0,0,0,0,0,2,2,0,Matches
305,295,Jesús Navas,DF,es Spain,38-234,1985,1.7,3,2,1,2,0,0,0,,0,2,0,2,1,4,11,0,Matches
306,296,Dan Ndoye,"MF,DF",ch Switzerland,23-261,2000,4.5,5,3,4,1,0,1,2,50.0,1,3,0,3,2,7,2,0,Matches
307,297,Pedro Neto,"DF,FW",pt Portugal,24-125,2000,1.3,5,1,2,2,1,2,2,100.0,0,0,0,0,2,7,1,0,Matches
308,298,Manuel Neuer,GK,de Germany,38-107,1986,5.3,0,0,0,0,0,0,0,,0,0,0,0,0,0,1,1,Matches
309,299,João Neves,MF,pt Portugal,19-289,2004,0.9,0,0,0,0,0,0,0,,0,1,0,1,5,5,0,0,Matches
310,300,Rúben Neves,MF,pt Portugal,27-121,1997,1.4,3,1,0,2,1,0,1,0.0,1,3,1,2,1,4,1,0,Matches
312,301,Florin Niță,GK,ro Romania,37-009,1987,4.0,0,0,0,0,0,0,0,,0,0,0,0,0,0,2,0,Matches
313,302,Matheus Nunes,MF,pt Portugal,25-320,1998,0.2,0,0,0,0,0,0,0,,0,0,0,0,0,0,0,0,Matches
314,303,Christian Nørgaard,MF,dk Denmark,30-124,1994,0.4,1,0,0,1,0,1,1,100.0,0,0,0,0,0,1,1,0,Matches
315,304,Adam Obert,DF,sk Slovakia,21-324,2002,0.3,1,1,0,1,0,1,1,100.0,0,0,0,0,0,1,1,0,Matches
316,305,Jan Oblak,GK,si Slovenia,31-187,1993,4.3,0,0,0,0,0,0,0,,0,0,0,0,0,0,1,0,Matches
317,306,Darius Olaru,MF,ro Romania,26-131,1998,0.3,0,0,0,0,0,0,0,,0,0,0,0,0,0,0,0,Matches
318,307,Dani Olmo,"MF,FW",es Spain,26-066,1998,3.8,3,3,1,1,1,3,5,60.0,2,1,0,1,2,5,2,0,Matches
319,308,Amadou Onana,MF,be Belgium,22-331,2001,4.0,8,6,3,4,1,4,5,80.0,1,7,1,6,3,11,4,2,Matches
320,309,Loïs Openda,FW,be Belgium,24-147,2000,0.8,2,1,0,0,2,0,0,,0,1,0,1,1,3,1,0,Matches
321,310,Willi Orban,DF,hu Hungary,31-252,1992,3.0,7,7,7,0,0,3,3,100.0,0,9,7,2,1,8,9,1,Matches
322,311,Mikel Oyarzabal,FW,es Spain,27-082,1997,2.0,1,0,0,0,1,0,0,,0,2,0,2,0,1,4,0,Matches
323,312,Salih Özcan,MF,tr Türkiye,26-183,1998,1.7,6,3,1,5,0,2,3,66.7,1,0,0,0,7,13,4,0,Matches
324,313,João Palhinha,MF,pt Portugal,29-003,1995,3.3,15,9,5,8,2,7,10,70.0,3,6,1,5,8,23,6,0,Matches
325,314,Cole Palmer,"MF,FW",eng England,22-067,2002,1.4,1,0,1,0,0,1,2,50.0,1,1,0,1,0,1,0,0,Matches
326,315,Mario Pašalić,"FW,MF",hr Croatia,29-154,1995,1.3,1,0,1,0,0,0,0,,0,0,0,0,0,1,2,0,Matches
327,316,Strahinja Pavlović,DF,rs Serbia,23-049,2001,3.0,11,6,7,3,1,9,14,64.3,5,2,0,2,4,15,10,0,Matches
328,317,Pedri,MF,es Spain,21-230,2002,2.1,6,3,1,4,1,2,4,50.0,2,0,0,0,1,7,0,0,Matches
329,318,Peter Pekarík,DF,sk Slovakia,37-256,1986,4.2,1,0,1,0,0,1,4,25.0,3,4,3,1,7,8,11,0,Matches
330,319,Lorenzo Pellegrini,"FW,MF",it Italy,28-023,1996,2.4,2,0,1,1,0,1,4,25.0,3,3,0,3,2,4,2,0,Matches
331,320,Patrick Pentz,GK,at Austria,27-192,1997,4.0,0,0,0,0,0,0,0,,0,0,0,0,0,0,3,1,Matches
332,321,Pepe,DF,pt Portugal,41-137,1983,4.5,9,5,5,3,1,7,13,53.8,6,3,2,1,5,14,26,1,Matches
333,322,Danilo Pereira,DF,pt Portugal,32-307,1991,1.0,0,0,0,0,0,0,0,,0,0,0,0,1,1,2,0,Matches
334,323,Ayoze Pérez,FW,es Spain,30-349,1993,0.1,0,0,0,0,0,0,0,,0,1,0,1,0,0,0,0,Matches
335,324,Ivan Perišić,"DF,FW",hr Croatia,35-161,1989,1.5,0,0,0,0,0,0,0,,0,1,0,1,1,1,3,0,Matches
336,325,Bruno Petković,FW,hr Croatia,29-300,1994,1.0,0,0,0,0,0,0,1,0.0,1,0,0,0,0,0,1,0,Matches
338,326,Krzysztof Piątek,FW,pl Poland,29-011,1995,0.7,1,1,0,1,0,0,0,,0,0,0,0,0,1,0,0,Matches
339,327,Jordan Pickford,GK,eng England,30-127,1994,6.7,0,0,0,0,0,0,0,,0,0,0,0,0,0,1,0,Matches
340,328,Jakub Piotrowski,MF,pl Poland,26-282,1997,0.6,0,0,0,0,0,0,0,,0,0,0,0,0,0,1,0,Matches
341,329,Marin Pongračić,DF,hr Croatia,26-305,1997,2.0,2,1,2,0,0,0,4,0.0,4,6,3,3,2,4,9,0,Matches
342,330,Ryan Porteous,DF,sct Scotland,25-109,1999,0.5,2,1,2,0,0,2,2,100.0,0,0,0,0,0,2,1,0,Matches
343,331,Stefan Posch,DF,at Austria,27-059,1997,4.0,15,9,4,8,3,9,13,69.2,4,11,4,7,6,21,11,0,Matches
344,332,Yussuf Poulsen,"FW,MF",dk Denmark,30-027,1994,0.6,1,0,0,0,1,1,2,50.0,1,1,0,1,0,1,1,0,Matches
345,333,Alexander Prass,DF,at Austria,23-047,2001,1.8,7,2,4,2,1,4,10,40.0,6,1,0,1,2,9,1,0,Matches
346,334,Lukáš Provod,MF,cz Czechia,27-263,1996,2.6,5,5,2,1,2,3,5,60.0,2,3,1,2,0,5,2,0,Matches
347,335,George Pușcaș,FW,ro Romania,28-095,1996,0.4,0,0,0,0,0,0,1,0.0,1,0,0,0,0,0,1,0,Matches
348,336,Leopold Querfeld,DF,at Austria,20-205,2003,0.3,2,2,1,1,0,2,2,100.0,0,0,0,0,1,3,1,0,Matches
349,337,Adrien Rabiot,MF,fr France,29-100,1995,4.1,9,5,3,5,1,4,5,80.0,1,3,0,3,1,10,2,0,Matches
350,338,Bogdan Racovitan,DF,ro Romania,24-036,2000,0.6,0,0,0,0,0,0,1,0.0,1,2,2,0,1,1,3,1,Matches
351,339,Predrag Rajković,GK,rs Serbia,28-255,1995,3.0,0,0,0,0,0,0,0,,0,0,0,0,0,0,0,0,Matches
352,340,Anthony Ralston,DF,sct Scotland,25-239,1998,2.9,3,2,3,0,0,1,3,33.3,2,5,1,4,1,4,7,1,Matches
353,341,Ylber Ramadani,MF,al Albania,28-091,1996,2.9,6,3,2,3,1,5,9,55.6,4,8,3,5,4,10,4,0,Matches
354,342,Gonçalo Ramos,FW,pt Portugal,23-022,2001,0.3,0,0,0,0,0,0,0,,0,1,0,1,0,0,1,0,Matches
355,343,Giacomo Raspadori,FW,it Italy,24-145,2000,0.9,3,1,1,2,0,1,2,50.0,1,0,0,0,0,3,0,0,Matches
356,344,Andrei Ratiu,DF,ro Romania,26-022,1998,4.0,6,5,4,2,0,4,5,80.0,1,6,2,4,6,12,15,0,Matches
357,345,David Raum,DF,de Germany,26-081,1998,1.8,5,5,3,1,1,5,7,71.4,2,1,0,1,0,5,1,0,Matches
358,346,David Raya,GK,es Spain,28-301,1995,1.0,0,0,0,0,0,0,0,,0,0,0,0,0,0,0,0,Matches
359,347,Tijjani Reijnders,MF,nl Netherlands,25-349,1998,5.5,8,6,1,7,0,3,5,60.0,2,5,1,4,6,14,4,0,Matches
360,348,Mateo Retegui,FW,it Italy,25-074,1999,1.7,2,1,0,1,1,0,1,0.0,1,1,0,1,0,2,0,0,Matches
361,349,Declan Rice,MF,eng England,25-180,1999,6.7,18,14,10,6,2,5,8,62.5,3,3,0,3,6,24,10,0,Matches
362,350,Fabian Rieder,MF,ch Switzerland,22-147,2002,2.4,7,3,1,4,2,3,5,60.0,2,2,1,1,0,7,1,0,Matches
364,351,Andrew Robertson,DF,sct Scotland,30-123,1994,3.0,8,5,4,4,0,8,10,80.0,2,2,0,2,1,9,10,1,Matches
365,352,Rodri,MF,es Spain,28-020,1996,5.3,13,7,4,8,1,4,8,50.0,4,5,2,3,0,13,10,0,Matches
366,353,Ricardo Rodríguez,DF,ch Switzerland,31-322,1992,5.3,7,6,2,3,2,3,4,75.0,1,5,2,3,3,10,19,0,Matches
367,354,Taras Romanchuk,MF,pl Poland,32-241,1991,0.6,2,1,2,0,0,1,2,50.0,1,1,0,1,0,2,1,0,Matches
368,355,Cristiano Ronaldo,FW,pt Portugal,39-158,1985,5.4,1,1,0,0,1,1,1,100.0,0,1,1,0,0,1,1,0,Matches
369,356,Antonio Rüdiger,DF,de Germany,31-131,1993,5.3,8,4,7,1,0,6,6,100.0,0,10,6,4,2,10,20,0,Matches
370,357,Fabián Ruiz Peña,MF,es Spain,28-100,1996,5.0,5,2,3,0,2,2,5,40.0,3,1,0,1,4,9,5,1,Matches
371,358,Adrian Rus,MF,ro Romania,28-116,1996,0.2,0,0,0,0,0,0,0,,0,0,0,0,0,0,0,0,Matches
372,359,Marcel Sabitzer,"FW,MF",at Austria,30-117,1994,4.0,2,1,0,1,1,2,2,100.0,0,2,0,2,3,5,1,0,Matches
373,360,Bukayo Saka,"FW,DF",eng England,22-311,2001,6.0,5,4,2,3,0,2,3,66.7,1,5,0,5,1,6,11,0,Matches
374,361,Bartosz Salamon,DF,pl Poland,33-072,1991,0.9,3,2,2,1,0,2,2,100.0,0,1,0,1,2,5,7,0,Matches
375,362,William Saliba,DF,fr France,23-110,2001,6.3,5,2,3,2,0,2,3,66.7,1,6,3,3,4,9,30,0,Matches
376,363,Roland Sallai,MF,hu Hungary,27-051,1997,3.0,4,2,1,1,2,1,2,50.0,1,0,0,0,1,5,1,0,Matches
377,364,Lazar Samardzic,MF,rs Serbia,22-139,2002,0.6,0,0,0,0,0,0,0,,0,0,0,0,0,0,0,0,Matches
378,365,Leroy Sané,FW,de Germany,28-183,1996,2.3,1,1,1,0,0,0,5,0.0,5,2,0,2,0,1,0,0,Matches
379,366,Leo Sauer,FW,sk Slovakia,18-209,2005,0.1,0,0,0,0,0,0,0,,0,0,0,0,0,0,0,0,Matches
380,367,Gianluca Scamacca,FW,it Italy,25-193,1999,2.8,1,1,0,0,1,0,0,,0,0,0,0,2,3,1,0,Matches
381,368,András Schäfer,MF,hu Hungary,25-090,1999,3.0,6,3,0,6,0,1,3,33.3,2,4,1,3,1,7,3,0,Matches
382,369,Fabian Schär,DF,ch Switzerland,32-205,1991,5.3,10,4,7,0,3,4,7,57.1,3,6,4,2,9,19,24,0,Matches
383,370,Patrik Schick,FW,cz Czechia,28-170,1996,1.4,1,1,1,0,0,0,3,0.0,3,1,0,1,1,2,4,0,Matches
384,371,Nico Schlotterbeck,DF,de Germany,24-224,1999,1.3,1,1,0,1,0,0,2,0.0,2,1,0,1,2,3,8,1,Matches
385,372,Kasper Schmeichel,GK,dk Denmark,37-250,1986,4.0,0,0,0,0,0,0,0,,0,0,0,0,0,0,0,0,Matches
386,373,Romano Schmid,"FW,MF",at Austria,24-167,2000,1.6,2,1,0,1,1,1,3,33.3,2,6,0,6,0,2,2,0,Matches
387,374,Jerdy Schouten,MF,nl Netherlands,27-182,1997,5.6,7,3,2,4,1,1,5,20.0,4,5,2,3,5,12,8,0,Matches
388,375,Ivan Schranz,FW,sk Slovakia,30-303,1993,3.7,3,1,3,0,0,1,3,33.3,2,0,0,0,2,5,9,0,Matches
390,376,Taulant Seferi,FW,al Albania,27-240,1996,1.0,2,2,0,2,0,2,5,40.0,3,0,0,0,2,4,2,0,Matches
391,377,Nicolas Seiwald,MF,at Austria,23-069,2001,4.0,15,7,5,8,2,4,11,36.4,7,5,1,4,6,21,8,0,Matches
392,378,Nélson Semedo,DF,pt Portugal,30-239,1993,1.1,3,2,2,1,0,2,6,33.3,4,1,0,1,0,3,0,0,Matches
393,379,Benjamin Šeško,FW,si Slovenia,21-042,2003,4.0,3,1,1,1,1,1,5,20.0,4,3,1,2,0,3,5,0,Matches
394,380,Petr Ševčík,MF,cz Czechia,30-069,1994,0.2,0,0,0,0,0,0,0,,0,0,0,0,0,0,0,0,Matches
395,381,Stephan El Shaarawy,FW,it Italy,31-259,1992,0.5,0,0,0,0,0,0,0,,0,0,0,0,0,0,2,0,Matches
396,382,Lawrence Shankland,FW,sct Scotland,28-337,1995,0.3,1,0,1,0,0,1,1,100.0,0,2,0,2,0,1,1,0,Matches
397,383,Mykola Shaparenko,MF,ua Ukraine,25-282,1998,2.4,3,0,2,1,0,3,4,75.0,1,4,0,4,3,6,1,0,Matches
398,384,Xherdan Shaqiri,"MF,FW",ch Switzerland,32-276,1991,0.8,0,0,0,0,0,0,0,,0,0,0,0,0,0,0,0,Matches
399,385,Luke Shaw,DF,eng England,29-000,1995,1.0,0,0,0,0,0,0,0,,0,0,0,0,1,1,2,0,Matches
400,386,Vincent Sierro,MF,ch Switzerland,28-278,1995,0.4,0,0,0,0,0,0,1,0.0,1,1,1,0,0,0,1,0,Matches
401,387,António Silva,DF,pt Portugal,20-256,2003,0.8,1,1,1,0,0,0,0,,0,0,0,0,0,1,2,1,Matches
402,388,Bernardo Silva,"FW,MF",pt Portugal,29-337,1994,4.7,5,4,1,3,1,1,6,16.7,5,2,0,2,0,5,3,0,Matches
403,389,Unai Simón,GK,es Spain,27-031,1997,5.3,0,0,0,0,0,0,0,,0,0,0,0,0,0,3,1,Matches
404,390,Xavi Simons,"MF,FW",nl Netherlands,21-082,2003,5.0,8,5,3,4,1,5,6,83.3,1,7,0,7,5,13,0,0,Matches
405,391,Michał Skóraś,DF,pl Poland,24-148,2000,0.3,1,1,0,1,0,0,0,,0,0,0,0,1,2,1,0,Matches
406,392,Łukasz Skorupski,GK,pl Poland,33-068,1991,1.0,0,0,0,0,0,0,0,,0,0,0,0,0,0,4,0,Matches
407,393,Andreas Skov Olsen,"MF,FW",dk Denmark,24-196,1999,1.4,1,1,0,0,1,1,2,50.0,1,2,0,2,0,1,2,0,Matches
408,394,Milan Škriniar,DF,sk Slovakia,29-152,1995,4.3,3,1,3,0,0,2,4,50.0,2,4,4,0,2,5,17,0,Matches
409,395,Bartosz Slisz,MF,pl Poland,25-105,1999,1.2,1,1,0,0,1,0,0,,0,1,0,1,2,3,3,0,Matches
410,396,Yann Sommer,GK,ch Switzerland,35-208,1988,5.3,0,0,0,0,0,0,0,,0,0,0,0,0,0,2,0,Matches
411,397,Deian Sorescu,"MF,DF",ro Romania,26-318,1997,0.4,0,0,0,0,0,0,0,,0,1,0,1,1,1,1,0,Matches
412,398,Borna Sosa,DF,hr Croatia,26-173,1998,0.1,0,0,0,0,0,0,1,0.0,1,1,1,0,0,0,0,0,Matches
413,399,Tomáš Souček,MF,cz Czechia,29-136,1995,3.0,5,3,2,2,1,3,6,50.0,3,6,2,4,3,8,5,0,Matches
414,400,Andraž Šporar,FW,si Slovenia,30-136,1994,3.8,2,2,1,0,1,1,1,100.0,0,2,1,1,0,2,4,0,Matches
416,401,Nicolae Stanciu,"MF,FW",ro Romania,31-066,1993,3.9,3,2,1,2,0,1,4,25.0,3,1,1,0,1,4,5,0,Matches
417,402,Jindřich Staněk,GK,cz Czechia,28-076,1996,2.6,0,0,0,0,0,0,0,,0,0,0,0,0,0,1,0,Matches
418,403,Josip Stanišić,DF,hr Croatia,24-101,2000,2.0,10,8,3,5,2,5,9,55.6,4,3,1,2,4,14,2,0,Matches
419,404,Renato Steffen,DF,ch Switzerland,32-252,1991,0.0,0,0,0,0,0,0,0,,0,0,0,0,0,0,0,0,Matches
420,405,Taras Stepanenko,MF,ua Ukraine,34-339,1989,0.9,3,3,3,0,0,3,5,60.0,2,2,1,1,1,4,2,0,Matches
421,406,Leonidas Stergiou,DF,ch Switzerland,22-131,2002,0.5,4,2,3,1,0,1,3,33.3,2,0,0,0,0,4,4,0,Matches
422,407,Petar Stojanović,MF,si Slovenia,28-279,1995,3.5,6,5,5,1,0,3,8,37.5,5,4,1,3,1,7,4,0,Matches
423,408,John Stones,DF,eng England,30-045,1994,6.7,4,3,2,1,1,2,2,100.0,0,2,2,0,1,5,14,0,Matches
424,409,Thomas Strakosha,GK,al Albania,29-115,1995,3.0,0,0,0,0,0,0,0,,0,0,0,0,0,0,1,0,Matches
425,410,Dávid Strelec,FW,sk Slovakia,23-099,2001,2.0,0,0,0,0,0,0,0,,0,2,0,2,0,0,0,0,Matches
426,411,Callum Styles,MF,hu Hungary,24-106,2000,0.7,0,0,0,0,0,0,1,0.0,1,0,0,0,1,1,1,0,Matches
427,412,Luka Sučić,"FW,MF",hr Croatia,21-308,2002,1.6,0,0,0,0,0,0,0,,0,4,0,4,1,1,1,0,Matches
428,413,Heorhiy Sudakov,MF,ua Ukraine,21-315,2002,2.9,3,1,2,1,0,3,4,75.0,1,4,1,3,0,3,1,0,Matches
429,414,Pavel Šulc,MF,cz Czechia,23-196,2000,0.9,1,1,1,0,0,1,2,50.0,1,1,1,0,1,2,2,0,Matches
430,415,Tomáš Suslov,"FW,MF",sk Slovakia,22-035,2002,1.4,4,1,1,3,0,1,4,25.0,3,4,0,4,1,5,0,0,Matches
431,416,Josip Šutalo,DF,hr Croatia,24-135,2000,3.0,5,3,5,0,0,2,3,66.7,1,6,5,1,13,18,7,1,Matches
432,417,Oleksandr Svatok,DF,ua Ukraine,29-289,1994,0.9,0,0,0,0,0,0,0,,0,2,1,1,3,3,2,0,Matches
433,418,Karol Świderski,FW,pl Poland,27-171,1997,1.0,0,0,0,0,0,0,0,,0,0,0,0,0,0,0,0,Matches
434,419,Serhiy Sydorchuk,MF,ua Ukraine,33-071,1991,0.1,0,0,0,0,0,0,0,,0,0,0,0,0,0,0,0,Matches
435,420,Attila Szalai,DF,hu Hungary,26-174,1998,1.1,2,2,2,0,0,1,3,33.3,2,0,0,0,2,4,2,0,Matches
436,421,Wojciech Szczęsny,GK,pl Poland,34-085,1990,2.0,0,0,0,0,0,0,1,0.0,1,1,0,1,0,0,2,0,Matches
437,422,Dominik Szoboszlai,MF,hu Hungary,23-261,2000,3.0,2,0,0,1,1,0,0,,0,4,1,3,2,4,6,0,Matches
438,423,Sebastian Szymański,MF,pl Poland,25-063,1999,1.2,7,2,5,2,0,5,10,50.0,5,3,1,2,3,10,1,0,Matches
439,424,Dušan Tadić,MF,rs Serbia,35-235,1988,1.7,2,2,0,1,1,0,0,,0,1,0,1,1,3,3,0,Matches
440,425,Jonathan Tah,DF,de Germany,28-152,1996,3.5,2,1,1,1,0,1,1,100.0,0,2,1,1,4,6,11,0,Matches
442,426,Maksym Talovierov,MF,ua Ukraine,24-014,2000,0.0,0,0,0,0,0,0,0,,0,0,0,0,0,0,0,0,Matches
443,427,Aurélien Tchouaméni,MF,fr France,24-167,2000,5.2,9,7,3,4,2,3,8,37.5,5,2,1,1,5,14,10,1,Matches
444,428,Arthur Theate,DF,be Belgium,24-048,2000,2.8,2,2,0,0,2,0,1,0.0,1,5,0,5,2,4,9,0,Matches
445,429,Marcus Thuram,FW,fr France,26-341,1997,2.9,2,2,0,0,2,0,0,,0,6,2,4,0,2,2,0,Matches
446,430,Youri Tielemans,MF,be Belgium,27-066,1997,1.6,2,2,1,1,0,0,1,0.0,1,3,1,2,1,3,0,0,Matches
447,431,Kieran Tierney,DF,sct Scotland,27-037,1997,1.5,2,1,2,0,0,1,3,33.3,2,1,1,0,0,2,4,0,Matches
448,432,Ivan Toney,FW,eng England,28-118,1996,0.5,1,1,0,1,0,0,0,,0,0,0,0,0,1,1,0,Matches
449,433,Ferrán Torres,"FW,MF",es Spain,24-134,2000,1.7,0,0,0,0,0,0,1,0.0,1,3,0,3,1,1,1,0,Matches
450,434,Cenk Tosun,FW,tr Türkiye,33-035,1991,0.3,0,0,0,0,0,0,0,,0,0,0,0,0,0,0,0,Matches
451,435,Gernot Trauner,DF,at Austria,32-109,1992,1.0,2,1,2,0,0,0,1,0.0,1,2,2,0,1,3,1,0,Matches
452,436,Kieran Trippier,DF,eng England,33-297,1990,5.0,7,4,3,3,1,3,8,37.5,5,3,1,2,5,12,8,0,Matches
453,437,Leandro Trossard,FW,be Belgium,29-221,1994,1.9,2,1,1,1,0,1,2,50.0,1,2,0,2,0,2,0,0,Matches
454,438,Anatolii Trubin,GK,ua Ukraine,22-346,2001,2.0,0,0,0,0,0,0,0,,0,0,0,0,0,0,1,0,Matches
455,439,Heorhii Tsitaishvili,"DF,MF",ge Georgia,23-237,2000,2.1,5,4,5,0,0,3,3,100.0,0,0,0,0,0,5,3,1,Matches
456,440,Viktor Tsyhankov,FW,ua Ukraine,26-240,1997,0.7,0,0,0,0,0,0,1,0.0,1,1,0,1,0,0,1,0,Matches
457,441,Ľubomír Tupta,MF,sk Slovakia,26-107,1998,0.1,0,0,0,0,0,0,0,,0,0,0,0,0,0,0,0,Matches
458,442,Oleksandr Tymchyk,DF,ua Ukraine,27-174,1997,2.2,10,4,5,5,0,6,12,50.0,6,2,0,2,3,13,6,0,Matches
459,443,Deniz Undav,MF,de Germany,27-359,1996,0.1,1,1,0,0,1,1,1,100.0,0,0,0,0,0,1,0,0,Matches
460,444,Dayot Upamecano,DF,fr France,25-259,1998,6.3,9,7,6,3,0,5,6,83.3,1,3,1,2,6,15,24,0,Matches
461,445,Kacper Urbanski,"FW,MF",pl Poland,19-309,2004,1.6,2,1,2,0,0,1,3,33.3,2,2,0,2,1,3,2,0,Matches
462,446,Virgil van Dijk,DF,nl Netherlands,33-004,1991,6.0,4,2,4,0,0,1,1,100.0,0,5,4,1,2,6,36,1,Matches
463,447,Vladyslav Vanat,FW,ua Ukraine,22-190,2002,0.2,0,0,0,0,0,0,0,,0,0,0,0,0,0,0,0,Matches
464,448,Barnabás Varga,FW,hu Hungary,30-169,1994,2.8,4,1,1,2,1,2,2,100.0,0,5,1,4,1,5,7,0,Matches
465,449,Ruben Vargas,"MF,FW",ch Switzerland,25-342,1998,3.4,6,5,3,2,1,2,4,50.0,2,5,0,5,2,8,4,1,Matches
466,450,Denis Vavro,DF,sk Slovakia,28-093,1996,4.3,2,1,2,0,0,2,4,50.0,2,6,5,1,2,4,18,0,Matches
468,451,Joey Veerman,MF,nl Netherlands,25-236,1998,2.3,3,1,1,1,1,3,7,42.9,4,4,1,3,1,4,1,0,Matches
469,452,Miloš Veljković,DF,rs Serbia,28-290,1995,3.0,2,0,2,0,0,2,2,100.0,0,0,0,0,0,2,6,0,Matches
470,453,Micky van de Ven,DF,nl Netherlands,23-084,2001,0.8,1,1,1,0,0,1,2,50.0,1,2,1,1,0,1,5,0,Matches
471,454,Benjamin Verbič,MF,si Slovenia,30-228,1993,0.8,3,2,1,2,0,1,3,33.3,2,0,0,0,1,4,2,0,Matches
472,455,Bart Verbruggen,GK,nl Netherlands,21-329,2002,6.0,1,1,1,0,0,0,0,,0,0,0,0,0,1,4,0,Matches
473,456,Jan Vertonghen,DF,be Belgium,37-079,1987,3.0,4,2,1,3,0,0,0,,0,2,1,1,0,4,10,0,Matches
474,457,Jannik Vestergaard,DF,dk Denmark,31-344,1992,4.0,3,3,3,0,0,3,3,100.0,0,3,2,1,4,7,12,0,Matches
475,458,Žan Vipotnik,FW,si Slovenia,22-116,2002,0.2,0,0,0,0,0,0,1,0.0,1,0,0,0,0,0,1,0,Matches
476,459,Vitinha,MF,pt Portugal,24-150,2000,4.0,3,3,0,2,1,1,3,33.3,2,3,1,2,2,5,3,0,Matches
477,460,Daniel Vivian,DF,es Spain,24-363,1999,1.4,2,2,2,0,0,2,3,66.7,1,1,1,0,1,3,10,0,Matches
478,461,Dušan Vlahović,"MF,FW",rs Serbia,24-166,2000,2.0,0,0,0,0,0,0,1,0.0,1,0,0,0,1,1,0,0,Matches
479,462,Stefan de Vrij,DF,nl Netherlands,32-158,1992,6.0,12,7,7,4,1,8,10,80.0,2,6,2,4,2,14,20,0,Matches
480,463,Kyle Walker,DF,eng England,34-045,1990,6.7,5,2,2,2,1,2,4,50.0,2,5,1,4,5,10,6,0,Matches
481,464,Ollie Watkins,FW,eng England,28-195,1995,0.4,0,0,0,0,0,0,0,,0,0,0,0,1,1,0,0,Matches
482,465,Wout Weghorst,FW,nl Netherlands,31-340,1992,1.5,2,1,1,1,0,1,1,100.0,0,2,1,1,0,2,2,0,Matches
483,466,Andreas Weimann,FW,at Austria,32-342,1991,0.0,0,0,0,0,0,0,0,,0,0,0,0,0,0,0,0,Matches
484,467,Silvan Widmer,DF,ch Switzerland,31-129,1993,3.3,2,1,1,1,0,1,1,100.0,0,3,1,2,2,4,11,0,Matches
485,468,Georginio Wijnaldum,MF,nl Netherlands,33-244,1990,0.8,0,0,0,0,0,0,0,,0,0,0,0,0,0,0,0,Matches
486,469,Nico Williams,FW,es Spain,22-000,2002,4.5,3,2,0,1,2,1,5,20.0,4,4,0,4,0,3,1,0,Matches
487,470,Patrick Wimmer,"FW,MF",at Austria,23-043,2001,1.5,2,2,0,2,0,1,5,20.0,4,4,0,4,0,2,1,0,Matches
488,471,Jonas Wind,FW,dk Denmark,25-156,1999,2.1,0,0,0,0,0,0,1,0.0,1,1,0,1,0,0,1,0,Matches
489,472,Florian Wirtz,"FW,MF",de Germany,21-070,2003,3.1,3,3,0,2,1,1,3,33.3,2,3,0,3,1,4,1,0,Matches
490,473,Maximilian Wöber,DF,at Austria,26-159,1998,1.9,4,3,2,2,0,2,3,66.7,1,3,2,1,4,8,6,0,Matches
491,474,Granit Xhaka,MF,ch Switzerland,31-289,1992,5.3,8,5,3,4,1,4,6,66.7,2,5,4,1,1,9,15,0,Matches
492,475,Lamine Yamal,FW,es Spain,16-365,2007,4.6,10,6,5,4,1,4,8,50.0,4,5,0,5,3,13,1,0,Matches
494,476,Roman Yaremchuk,FW,ua Ukraine,28-228,1995,1.3,0,0,0,0,0,0,2,0.0,2,1,1,0,0,0,1,0,Matches
495,477,Andriy Yarmolenko,"FW,MF",ua Ukraine,34-263,1989,1.2,2,2,0,1,1,1,3,33.3,2,1,0,1,1,3,0,0,Matches
496,478,Yusuf Yazıcı,"MF,FW",tr Türkiye,27-165,1997,0.6,1,1,0,0,1,1,3,33.3,2,0,0,0,0,1,0,0,Matches
497,479,Kenan Yıldız,"FW,MF",tr Türkiye,19-069,2005,3.8,3,2,2,1,0,2,2,100.0,0,4,0,4,0,3,2,0,Matches
498,480,Okay Yokuşlu,"MF,DF",tr Türkiye,30-125,1994,0.6,2,1,1,1,0,0,1,0.0,1,2,0,2,2,4,4,0,Matches
499,481,İsmail Yüksek,MF,tr Türkiye,25-168,1999,1.7,6,2,2,3,1,3,5,60.0,2,2,1,1,1,7,4,0,Matches
500,482,Illia Zabarnyi,DF,ua Ukraine,21-315,2002,3.0,4,3,4,0,0,1,2,50.0,1,2,2,0,1,5,7,0,Matches
501,483,Mattia Zaccagni,"MF,FW",it Italy,29-026,1995,0.9,1,0,0,1,0,0,1,0.0,1,1,0,1,1,2,0,0,Matches
502,484,Denis Zakaria,MF,ch Switzerland,27-235,1996,0.3,0,0,0,0,0,0,0,,0,1,0,1,0,0,1,0,Matches
503,485,Nicola Zalewski,DF,pl Poland,22-171,2002,2.7,3,1,2,1,0,1,5,20.0,4,2,1,1,2,5,4,0,Matches
504,486,Piotr Zieliński,MF,pl Poland,30-053,1994,2.8,0,0,0,0,0,0,2,0.0,2,4,0,4,2,2,3,0,Matches
505,487,Oleksandr Zinchenko,DF,ua Ukraine,27-210,1996,2.4,6,5,4,1,1,4,8,50.0,4,4,1,3,1,7,4,0,Matches
506,488,Joshua Zirkzee,"FW,DF",nl Netherlands,23-051,2001,0.1,1,1,1,0,0,0,0,,0,0,0,0,0,1,0,0,Matches
507,489,Andrija Živković,DF,rs Serbia,28-001,1996,2.7,2,2,2,0,0,1,2,50.0,1,3,0,3,0,2,5,0,Matches
508,490,Budu Zivzivadze,"FW,MF",ge Georgia,30-124,1994,0.2,0,0,0,0,0,0,0,,0,0,0,0,0,0,0,0,Matches
509,491,Steven Zuber,MF,ch Switzerland,32-330,1991,0.9,0,0,0,0,0,0,1,0.0,1,0,0,0,0,0,0,0,Matches
510,492,Martín Zubimendi,MF,es Spain,25-161,1999,1.1,5,3,2,2,1,2,4,50.0,2,1,1,0,0,5,0,0,Matches
511,493,Oleksandr Zubkov,FW,ua Ukraine,27-344,1996,0.3,1,0,1,0,0,0,3,0.0,3,1,0,1,0,1,1,0,Matches
